一	二三左旦丁刁下上于士干不天王且丘本甘石百
乙	乞函吃屹迄疙挖涵山弓色龟九了七丁几匕又久夕子小己已
丁	叮打钉歹可汽盯顶何呵坷奇河苛一弓次行订贮
七	它十山轧缺掏淘萄摇遥缸陶
乃	孕仍奶扔秀透户乍作妒肩怎昨柔炸诱
九	夷旭仇姨胰丸友究疚鸠为染轨大弓孝痪郑
了	予承孔弓没吼序抒乳哼烹投股疫野阎击
二	三仁云元示完言些奈宗岸一左旦夸祟票祭禁御严污
人	什仆仙伙伐休仲佃囚八欠入久内午夫尺丘矢年
儿	允中山扎仙川充秃亮初袖袍乱里裸忠
入	件任作伯傀人竹俄化仰乒低俐系趴飞疹偏赁
八	筏符答叭扒竹签爪人亥黎以猴么欠囚
几	朵冗肌凡反风吭坑抗咒杭炕凰及皮凤冬各扳投板股返
刀	召分叨初刃切份吩岔扮券忿招拐沼芬昭
刁	叼长伺帚虐司侵套浸张寻胀慧一尸屋框妇扫雪筐
力	加胁另肋男幼劣劫助协咖勇茄荔筋
匕	比旨化切它尼屁庇批昆北此皂呢花指脂能
十	穴安宋什汁针七千士丈干午丰支斗古未末早耳
卜	仆扑朴亡上下六丹文斗占主立齐玄迂迅京迫送迷退回
又	奴廷建叉友反没夜延怪候只双桑及皮冬各吴扳投板股返侵怒疫庭
三	二些仁云元示完言奈宗岸票夸祟祭云禁御严辰韭
下	卡斥丐正定拆是卜一怔症堤提钙锭非政歪匙悲
丈	仗考孝杖老者宏姥堵奢屠暑煮着
上	此卡齿迂雌柴秽卜一言逗逼些延计戚
丸	执夕九夷爹仇外名旭姨胰痛势垫挚热
凡	帆夕几冗外名朵肌丸反歹多
久	灸欠吹坎炊疚钦之次玖砍飞亩登歌
么	鬼乏刃竹傀块愧槐帘筏戈公几匆私瑰魁魄
也	他地她弛池拖快柒心木施柴筷驰
乞	疙吃屹迄乙仔你函仍仙侯挖夜人侈健涵杰像
于	吁宇污芋迂五途某伍除木一冻徐媒煤
亡	妄忘忙芒盲氓茫荒玄丐女卜亥巡弦炫畜
刃	纫刀鬼韧么分召叨初傀块愧槐切份吩岔扮券忿招拐沼
勺	勾匀惦憾心灼芍钓慷惨戈句旬甸均怯的钧愧
千	朱舌卑段乖垂盾重恬括活株啤脾
叉	又太奴宏汰友反廷没夜怪建候只雄双夕及皮冬各吴扳投延
口	吐呆句回台吉如扣杏品只右古占石叫另叮叭叨叼吆
土	吉志吐杜灶肚丑王去主里地寺坎坏垃坦埋堆块
士	宇十一完宗定宣室家富宾演宜空轩崇喧家棕嫁
夕	多外名侈丸凡歹令宛爹移麦铭
大	左有灰因尖艾丈太夭天又力凶文九父犬右史矢夷
女	如安妥奸亡奴好她奸妒妙妖妓妹姑姐始姨娃
子	仔字好李孟存孝季享厚俘籽浮朵闲孕脖荸锰
寸	付寺守村肘咐府侍封恃持射时辱尉专符尊等对
小	亦赤弓金担胆奕瞻赡赦赫
尸	匹尿己已尺户力刀刁巨乍耳司匣尼屈居届屎屏屑展
山	扎儿仙已己屯巴匕凶七出乙目炭峭崩崔
川	顺训驯袖串袜中爪州划刷蚓划引儿仲冲片介
工	汞功攻巧贡扛江肛项红缸虹筑鸿
己	已忌改凹犯危扼卷范尼屈届纪桅倦脆圈
已	己忌改凹犯危扼卷范尼屈届纪桅倦脆圈
巾	布吊帖帕市央庸帆希布帘怖帝帅席帐幅帽满帜
干	刊奸汗旱杆肝竿敢罕岸悍捍杆焊舍轩秆干橄
弓	引欠小子夕久又几了九丑丁乙夷门斗弛粥
才	材闭柏槐牙皮财木竹杉板析株豺呀披波坡芽疲被黎
丑	扭钮羞疆纽土弓闺角型王主久去夕子小丁九了几又夷乙里
丐	钙下亡妄忙忘芒卡斥玄朽盲孩茫荒
不	否示坏杯杯平奈宗歪炭尔坪胚祟票祭灭禁碳御
中	儿忠引川仲冲史巾由甲串束斗肃初盅袒袖顺里裸
丰	邦慧技按蚌梆手十峰控捷湃锋拜绑蜂抖抹挖拷拧
丹	彤脐舟雨月卜帖肪腿旁泊船雪腋漏帜霍龙垄辞
之	乏芝泛眨久贬欠次吹坎灸炊疚钦饮永今闪
予	预豫序抒野舒多侈夕矛了爹移墅
云	二耘三元示云仁魂寿至虫乓晋室屋套完言些奈宗岸昙一
井	并并屏拼并阱耕瓶普沟构饼
互	瓦汇碌录畏剥瓶氯表长奴危好侯弱辱偎喂溺绿
五	伍悟捂晤梧于本语吁宇污芋迂笨
仁	三二僵合祭但仑些拿会低伍丘元云示全命盒
什	仗估午使家人伞值十卒率
仆	位住仿依赴信倍停人企禽侦卜什仙扑伙伐休仲朴佃于
仇	姨胰九夷旭轨究佑矢侠友丸别枚知布倚矣疚疾
仍	奶扔秀乃作孕透仔仿你户乍偏诱蹂乞
今	令含念贪伐伶吟筏代伏捻铃冷俊玲俯黔
介	串佛仲芥界患伸川候条袖片人而亚事拂沸训
元	二完三云示仁玩冠寇光院
允	充儿唐康庸划统州秃亮佣塘搪慷中戈山兜列洲班蚤强乡肆
内	呐钠丙肉佣柄病纳惫月人俘确俏陋俱婿盗温
六	交滚商与咬校嘀嫡摘滴适卜金狡郊效屿举
公	钱松镀金铺戈贱么突翁蚣钓贼镰分乓勾勺伐找针浅
冗	肌股几咒胳朵舀疫帆投疯反凡吭坑役抗佩杭炕段殷
凶	匈凶汹胸大山峡酗抛崎篡夭太天屯巴文父犬出右史丈已己
分	岔忿盆贫芬份吩扮刀叨初粉券氛纷召切招沼昭赖
切	砌比匕叨初能批刀分旨屁庇昆顷招沼昭岔券忿
匀	勾勺冰均钧次冶冻准憾藏灼芍惦钓慷赃
勾	勺匀惦憾心灼芍钓慷惨戈句旬甸均怯的钧愧
勿	忽吻易物惕锡必赐踢泌剔卑怕笑愧
化	比匙倾花仙批匕它尼屁庇昆北此能靴
匹	尸层金四司匣穴尿铅匠届公尼屈居松沿屎屏屑展针
午	什仗估伞十人卒使率许缺悴掏淘萄摇摔遥
升	竹飞血箕箭夭井户牛千册乍世必才甘白皿禾立匕刀
友	又夷九仇奴旭姨桑胰反叉丸疚痪廷没究夜怪建疫候只双
及	吸圾级反阁冬各扳板返壳皮又几叛客洛降格烙疼
反	冬各扳板返叛客洛格烙疼胳略逢
天	葵严大一助侯喉援暖
夫	替扶芙失推规承手人拖牧拾拴挫抚麸撵
太	宏汰雄叉篡戈大丸夭天凶文父犬夕寸右史去丈矢
夭	吞妖沃笑奏添乔契揍凑大竹劣楔侨舔娇桥
孔	吼乳孤孩孙逊了岳危扎仙儿弱预侯桅脆溺光元
少	炒炸火妙吵抄沙秒钞熄炎竹尖劣省砂烙煌
尤	就犬稽伏吠突哭臭莽袱献
尺	家尸人雇家嫁熬放于傲稼邀
屯	囤钝盹匈顿趋汹纯胸心山吨包雏
巴	把吧邑肥芭疤笆色爸耙爬捣靶日山皂
幻	幼以乐吆玄几弦炫烁似拗畜药始叽机砾关
引	弓中仲冲邢邦那阱阻郎郁限陌陈郑川剃蚓弟第
心	勾句勺旬甸志忠芯思屯必也世匀匈忙快怯怕恨恢悄
戈	台戒床勾勺公么伐找太犬寸夕去鬼
户	乍肩怎妒作扁昨炸雇房方成乃所窄
手	扎扑扣找夫牛丰用半年羊打扒托抄抖技扶扭把拉拌拄抹拒
扎	拙摧指携手毛甩把揣撬山扑仙扣儿找批尾
支	技妓吱枝肢求取歧翅娶最鼓水十救球撮
文	吝紊纹蚊悯大卜斑交送逛辽
斗	抖科料魁蚪斜卜十连斟蝌辛卓迅莲链
斤	欣匠折听析芹近斧所祈浙斩逝斯晰
方	于放施旅族仿妨坊房肪芳旋防旁旗纺淤游傍游榜
日	昌旦明旬昔晶巴白早百门旱旺昧昨冒倡唱暗
月	朋妥肚采有明胃内丹巾用皿目册且肖受冈冗同肋肌肝肘争周
木	林朴杏杜杰困休沐床宋呆采森本未末才寸子禾于也米束东果
欠	闪久灸疚阀之弓坎吹炊钦人乏芝煞合次玖砍亩歌
止	肯歧岁企扯址武啃趾正步遣怔涉症逃赋历
歹	死列殉残殃殊殖例尸咧歼夕丁
比	批庇屁昆能匕化切北此顷尼它旨皂
毛	毯尾耗撬牛毡扎件牢牡看毫
氏	昏只低抵底婚纸民衣她忘
水	汁沐冲尿支汛汗污池汪决汰沃沙沛沽沾沫法
火	炎少尖灶灰伙杰不半米肖灼炒炊炬炸烘淡痰燃
爪	条抓从笛笔箫八爬徐川修袱
父	爸交斧爹爷咬校大金究狡郊效奕绞较
片	版牌牍串亚川哑恶介患止斤工虫北兆徘袖顺罪
牙	邪雅鸦呀芽穿蚜讶辱才撑褥材畏表长柏案闭偎喂槐
牛	牡件牢牧看牲毛生失我物拜特湃
犬	伏吠尤突臭哭莽袱献为状拔泪伪嗅默
王	弄全玖汪玫枉旺玷珊班理琳斑瑰
丙	柄病陋内呐钠肉巫佣蒙俘准纳雁确惫
世	叶惜碟心屉虚蝶谍慌葬册必甘皿立井共升屯并曲羊
且	助姐宜沮阻祖租粗同肝具直真恒组蛆锄叠
丘	乒乓岳卸兵仁全合蚯人一伍何汽仑舍哈恰拾拴洽拿
主	住拄注柱往蛀土卜注达驻进远去立丹丑六文斗王下上亡
乍	户肩怎作妒扁昨炸雇房成方乃所窄
乏	芝泛眨之贬么久欠鬼饮灸疚帘次吹坎炊钦
乎	悉呼释窃米蟋咪屎迷籽料粒粗粥粤粱
以	似幻乐幼吆瓜玄几弧狐弦炫烁畜药
付	村肘咐府符休侍附寸守寺封射尉对俯传辱专尊
仔	好俘子字李籽你存孝季锰孕乞仍休浮猛享孟厚学
他	地她弛池拖也施驰休快柒付代仔仙仆什伙伐仲佃人
仗	杖什丈估使午老者考孝值猪酵做储宏伞
代	伐伏拭式今念伪佣试袋筏贷伶腻令含忍食仓惠
令	侈今爹含念多伶移贪铃伐冷玲
仙	化催人山花什仆伙伐休仲扎佃儿乞岳
充	允亮统弃儿率述遮玄秃育母卜唐庸康划州流梳
兄	况祝兑克竞悦脱嗅锐克息税阅吕叭呈吮咱蜕兢
册	皿删栅盅血仑孟扁珊杯益盔盏盟监冈
冬	各反疼返扳板终逢客冬叛洛格烙胳略
凹	巨已己忌拒炬凸局尼届屈犯危扼改卷范矩
出	屈拙茁倔祟掘窟山微亲览撬衬揽榄
凸	巨拒炬凹局争矩协荔挣净渠胀距筝
刊	干刑划列判删利刺到刮制刹削克剥副割剩划剑刽剂
加	咖力茄胁另肋男架嘉幼劫助协劣勇荔筋贺
功	攻工巧汞助项勤贡扛江肛劲胁肋勒勘
包	刨咆抱泡炮胞苞袍跑雹饱句
匆	勿吻忽易必鬼物惕愧锡么泌剔射傀块槐赐踢魄
北	兆此比化能批雌屁庇昆死匙姚挑桃逃匕它尼
半	拳判伴卷券拌胖畔眷叛倦圈绊胜手火
卡	下上斥迂此正丐言定拆是柴逗逼齿秽
占	店沾帖玷站惦图诸京贴点口卜享哀亮亭高掠凉逞景晾豪
去	劫怯法玉丢盖戈土城埃域塘磕
可	何呵坷奇河苛阿倚寄崎荷椅畸啊
古	胡固估咕姑居沽故枯苦舌个湖辜葫
右	若匿惹君吝吞佑知智口大各裙癌群诺
召	刀招沼昭叨绍超拐初照吩券岔忿芬刃切份扮
叮	打呵订钉丁盯吁咧汽可歹或呀啄哑啊
叨	初拐吩刀分切招沼昭召叼岔券忿
叼	刁伺叨虐侵浸慧妇扫长雪词吗呢归司帚
司	石拓泵刁伺祠洞桐砸铜筒后言哈恰拾洽砂砍研
叫	吆纠收民吴吐壮妆啸叽嚷口品
另	咖男胁力肋劣勇茄加努荔幼劫助协
只	口金吩兴哄右古占石六共父小句四回匹台穴吉吐如公扣呆杏
史	吏使中大驶央陕堕薇右甲由矢夷天太夭凶文父犬巾串丈
台	或怠名苔始抬治胎感戈冶店国口域铭
句	包心拘苟钩口咆回勾旬勺甸抱泡狗品炮胞苞袍
叭	扒趴八咳呈听呼咱啤唾呜鸣兄吕筏
四	田金囚回因匹困异黄囤固穴思胃铅
囚	田界人四因回困囤固欠佃八思胃甸圃仙以什仲仆伙
外	夕多名侈移爹铭歹丸凡令宛麦
央	映英鸯秧殃巾布吊然市庸肋盅胰奥袄
失	秩跌夫牛牧件扶牢牡芙替生毛我推
奴	又娱好怪吴怒只双挺健键努庭
奶	扔仍秀乃妒孕透奴好妨乍户娩诱作昨炸肩怎柔
孕	乃奶扔仍字李秀季游游存孝学仔好透
它	尼比屁庇昆匕化批皂能蛇
尼	屁它比呢庇昆匕化批皂能
巨	拒炬凹凸局矩渠距尸协荔乍尺户耳已己力刀刁匹尿衅
巧	功朽项工攻汞污夸贡扛江肛粤亏
左	奈痘奇病夸大二症一旦有灰三短
市	柿闹巾布吊帝央止庸肯盅逮希布帘帖帕怖帅席啼蒂满
布	希吊币布怖巾帘帝帅幕稀
平	坪砰秤萍不评示坏否杯炭宗奈杯
幼	拗劫幻以肋胁势助勘力另男乐功勉勃劲动勒勋勤
必	泌勿秘密怕愧匆吻忽易心竹性虎恬恤瑟蜜懊
打	叮钉丁盯拓订扛汽可歹振扼搓擂生表青差
扔	奶仍秀乃揉孕透扭乍户挽诱抒妒作昨炸拯换挺肩怎柔
扒	叭托抓拍趴八扳折拆括捣插捶播据揪契筏
扑	抖拉拄挤抗掠扯掉摘掖接搞摔擅拥攘手
斥	拆下诉卡斤后竿正丐匠折狂听析定芹近是威垢咸
旦	旱查量但旺坦袒是宣昼日晒昌二晨一捍悍杆焊汤
术	述麻穴摩空术么磨糜魔求甫蘑
本	笨五杆杯枉伍伟围苇违木一朽柄极韩
未	宋妹味昧朱守株木十珠朱宇字案栽殊蛛辣
末	沫抹茉杖枝枯木十栖杆棕植棺榕糊穗柠
正	政怔症歪征整止企扯址武肯遣步下歧逃啃
母	每拇姆毒侮海悔梅晦诲霉育敏流梳
民	氓眠氏叫她吆忘丧吴昏只
永	泳漾样咏之今吟拯蒸矛予令乏多含念芝郎
汁	沛沽凄滓溶泞滨泻沈湖潮水汗汛沫演十
犯	狂狗狠狈狸己已狐狡纪狼狭记配犹猖狰危卷
玄	畜弦炫吆乐蓄药以幻似舷烁么关亡拗叽机砾
玉	莹去王班琅球璧全汪弄法枉旺怯瑰
瓜	弧狐孤瓤瓢以瓣似系系玄幻吆乐县悬
瓦	瓶瓷互夕歹外多名畏辱
甘	某柑钳虚媒煤芋其甚垂甜嵌一苛华酣黄广蕾
生	甥性姓牲星笙产腥猩铲牛拜猜隆醒件牡牢青
用	佣甩惫月手桶通痛备胖皿目半册且牛羊年夫内丹丰
甩	用扎佣毛拙目尾指摧惫月手山批耗毫桶通痛毯备撬
田	四囚因回困胃思甸佃苗由甲曲里东果囤固男畏畔畦异
由	油抽宙笛袖娄申里裸更伸奄坤呻轴
甲	匣押钾申曼署蜀闸卖鸭伸坤呻万罢
申	伸坤呻畅神绅由甲娄搂屡楼篓匣油抽押宙
白	泉皂伯的泊拍怕皇柏迫魄帕腺
皮	颇波披坡疲被玻破菠板彼跛皱格簸
皿	册删盅栅血孟仑杯珊扁益盔盏盟监冈
目	盯盹相冒眼困睬瞄自贝盲省眉看盼眠眷眶湘厢睦睹
矛	务茅橘多侈雾予夕爹移抒序
矢	知矣枚矩疾收改玫牧故挨埃唉启短敞敢散矮敬
石	泵司拓砂研砍硝硼歌后言洞洽拾恰哈砰砸
示	二宗奈祟票祭禁御不坏杯三元云否斋崇仁捺棕
禾	私委和秋香番秃利季科秒租秘稍黍稚秉秀秤秦秩秧秆程菌萎
穴	容空术十麻金安究宋帘突窄述控腔
立	音位泣拉垃站章童意辛倍粒接竟培啦菩焙暗靖
丢	去任呈告怯法玉等劫廷浩淫逞造
乒	丘乓岳卸兵全合仁蚯少答御舍原气氧涂宿仑氛拿
乓	丘乒岳卸兵全云合至虫伐冶仁倒蚯
交	郊效咬校狡绞较六父饺爸滚
亦	奕迹赤小斗赦市止划前逮剂
亥	咳核刻玄孩该拥骇亡八畜牵叭扒巡逐
仿	坊妨肪防房芳纺旁访傍淤游方游
伙	伴俏灸倘人你火仲伐休仙佃什仆倦炎焦无
伊	裙君窘伺侵倔仲伙伐休伏仙仗作佃仇什仆人
伍	悟捂晤梧五语途仁除徐本于
伐	今伏代令含念筏伪佣俯人食仓阀付傀伶吟俊践袱戈贪
休	付茶条人仔他林保咐木府符伙伐仲佃仙沐仆什俯伟森集
伏	吠伪袱伐犬献代状默突哭臭莽兽今跋佣尤筏奖器
仲	候条介佛伸人中伙伐休佃仙冲仆什引川修芥界
件	俄牛牢任作伯牡傀湃入牧牲跌失我生毛看犁
任	呈廷件作伯傀浩造告入望窖圣
仰	抑迎昂柳唧脚铆系低旅节卿御聊鲫俐印作依卸却命
份	吩扮粉纷芬氛分岔忿盆拐俗刀贫寡伤叨初盼砌召剪
企	趾武址扯啃止肯历歧岁步正仆遣症怔涉逃赋
光	恍晃辉幌耀元岳完兆此北孔胚烦
凶	凶匈犯息兄见沉狂比狗虎狠狈狸臭猖媳熄
兆	姚挑桃逃北跳非贵尽齿遣溃遗
先	洗铣任告呈息丢兄儿廷沉虎浩臭淫逞造块媳熄
全	痊拴栓王汪旺枉皇闰弄狂合丘仁班斑
共	恭基供哄巷拱洪烘益异并寒斯港塞寨暴
再	王珊全弄汪旺枉现玉狂玖玫拴玷皇框栓
冰	次冻准冶匀冯冷凌凛凝汞均钧藏
列	歹划例咧殃死殉残殊到殖歼刑刊副划
刑	删荆划刊型列判利刺到制刹削剖刚剥副割剩划剑刽剂
划	列刑州刊利删判刺到制刹削剩剂别刨刷刮则剖刚副创
劣	另男胁勇省力肋努势茄荔劫助幼协咖勉动
匈	凶汹胸屯酗囤钝旬句甸勾勺凶心匀快恢盹峡
匠	所听折析芹近斧祈斩斯斤掀新欣浙逝晰
印	即卸剩却托宅仰抑迎柳铆孵昂节
危	桅脆诡跪扼配卷己已犯记忌纪弱
吉	告售周袁喜台土嘉口浩造台志杏品丧噩结周
吏	使史妻宙事乖丈刊捷凄栖中大十耽陕轴驶薇
同	合筒洞桐铜幅周且石肝豆咸壹
吊	帅布常巾帘帝啼币啸希席央市庸布帖帕怖砸满
吐	口哩唯土杜灶肚呈品堂吁吆叮叨吧叼吹
吁	污迂于宇芋叮呀呵途五或
各	冬反客洛格烙胳略阁路扳板返络赂酪骆
向	奥制晌尚自血懊澳袄衅筒咱高乔掌棠当
名	多夕铭台外侈或怠爹移麦宛令苔歹凡丸始抬
合	拿命盒仁仑咸登会同伺哈俭答恰拾洽豆凳合签全舍丘石何
吃	屹迄疙乞吟喉哈喻乙挖呛咐俭呐唯
后	垢石咸喊减司拓泵筒答斥斤同合豆竿
吆	叽砾玄叫以幻烁讥似哟畜乐药机拗絮关
因	男田咽姻恩茵畸大回囚四困囱更
回	图圆田茴回固口因囚困四句品向囤吉如扣台杏思胃
地	她弛池他也志驰均拖快柒施土
在	书布存昼画希布奄怖建褂中土大俺荐陡庵健掩淹陆
多	侈爹移夕名令外宛铭舞够
夷	九旭仇姨胰友丸究疚鸠为染轨大弓孝痪郑
夸	污亏奈垮胯朽巧聘跨三痘左夸
妄	亡忘盲奸芒忙氓巡茫荒玄安妥丐
奸	汗杆肝干旱竿轩罕橄敢悍捍杆焊刊岸
好	仔子字李籽奴存孝季锰孕奶俘浮猛孟享厚学
她	地弛池他也驰拖快民氏忘柒如好妹施婚女奸
如	娱女恕姑始口扣奸品唇好她奸妒妙妖奴妓加妹姐
字	孝李子好仔存季孕籽学孽锰宋孟享厚荸俘浮猛脖
存	荐字孝李季学子好仔孕籽猛锰
宇	芋于吁污迂士宋定室家五途
守	寺专宋寸付村肘辱尊封射尉对导未博
宅	托牢写印剩笋审安宋它穴客十守宇字宏宜宙忽宫宵筷忿
安	案按十妻宴女宋妥穴奸氨鞍宇守宅字妄它宏牢宙宜委姜宵
寺	封对守等侍恃持时寸付村肘特辱专尊夺待
尖	火炎大艾少驮驳燎灰契美奥痰因灶恢焕燃
屹	吃迄疙乞乙挖崔催仔你函夜吟伶汽侯旋偷摧龄仙
州	洲划酬川列班顺允唐康庸乡辨塘搪佣补慷强裤戈充盏
帆	帕凡巾肌帖帐帜冗幅帽股幌幔幢吊布
并	井并屏拼并阱耕瓶普沟构饼
年	手人件伴佣羊半用丘矢尺夫午内牛丰久入囚扣伐
式	贰拭代试腻忍二惠些左旦底三疟
弛	她地池他也驰拖快柒闷引施弓
忙	亡芒忘妄荒悼慌盲茫氓玄恨悴忆怀心丐
成	盛城乍户诚妒作肩怎昨炸茂方乃蝙
扣	捐拐揖捉损手拓拘抬口如找扑扎撰操捌品
扛	江肛红缸虹工筑汞攻功鸿巧贡项打折扯拓
托	宅扒拍印扳折抓拆括捣剩插捶抵播揪契笋
收	枚数嫩攻改牧玫故政启赦敞敢散敬敌矢矣疾
早	草卓章昧掉悼樟潭日十暑障
旨	匕比指脂昆尼它庇屁批化切白能
旬	恨悍心昏惕笋慢日惜嗜甸句勾勺昌怕晶悯
旭	夷九仇姨胰鸠间友丸究轨色疚涧为昌染晶简
曲	曹苗尊农槽遭茴茵描锚遵糟田童菌万瞄浓脓
有	肴大布月灰左胃朋郁淆育疚肩青疤病疾
朽	巧粤污夸聘杆杯枉亏柄垮胯本
朴	柱杭柿校梳檀椒木林核卜杜扑仆科料粒樟森
朱	株珠朱殊蛛未千宋妹味昧
朵	几跺躲冗闲肌子杭风李咒染梨凰反凡抗坑吭炕凤
次	姿咨冰玖坎吹炊砍准钦歌欣亩冻款欺饮久疚嵌
此	雌北比上齿化能批庇屁昆
死	尸歹殊殉庇毙殃残列比殖能批屁昆
汗	奸杆肝干旱竿污汪轩罕橄江汁河敢捍悍焊杆刊岸
污	吁迂于宇芋汗汪江沐河途五
江	扛肛鸿红缸虹工汞筑攻功巧贡项汗污汪
池	弛她地他也柒泌驰沐泡汹拖
污	夸亏聘朽巧涯浓仁垮胯愕三二
汛	迅讯汁涵没涣渔汗沐冲沛沫沽涨水筑
灰	痰然恢煞大燃炎熬火有左杰盔伪
百	陌宿日一宣厚厌喧压
竹	么八少臼禾白必乍牛户夭升才千鬼匕刀几入
米	籽屎咪迷料粒粗乎粉粥粱精糊糕糖糠粪糟
羊	差洋羞祥搓鲜芙氧翔群达癣
羽	翅翔翻扇翎翩翘戳塌嗡折翰翁习
老	姥丈杖仗者宏恩考孝慕协怒添带屠奢堵着煮暑
考	丈拷烤铐孝杖仗老者宏屠奢着煮暑宠协姥堵酵
而	耍耐揣喘瑞端需串儒懦帚糯
耳	取耿耻聂茸耽揖闻聪职居聊娶最聘椰锯联摄
肉	内腐瘸呐钠丙佣豪两柄俘纳病俩祭敞散敌惫离
肋	勇助胁筋励力男另劳幼劫功加勃胰勒勋协胜咖劣
肌	冗股几胳朵咒帆饥凯投疫舀脉脾抗役坑吭炕杭段般殷壳
臣	卧临宦藏赃坚肾脏鉴紧竖贤盐印即初卸柳聊铆
自	咱目首眉省算媚道楣篡瘪向看相冒狈奥箱边
至	到致屋室窒握倒致云蛙虫乓
臼	舀身焰舅滔鼠儿与躬陷稻桩写阎旧
舌	刮甜舔活括恬阔古千话刮固估沽居姑咕胡苦枯管
舟	泊船航舵舷艇艘舱舰丹帜向育奥自血母制流梳澳
色	巴艳邑把吧芭肥疤笆免旭间爸耙乙象兔皂爬挽娩晚冕靶捣
艾	若哎荚茄荔惹送美茵荐匿莫大尖芯昔苗郑
虫	虫蚊蚪蚓蚌蚣蛆蚯蛀蛙蛔虹蛇蛛蛤蛾蜻蜘蝴蝶
血	恤皿册盆向盅栅扁奥荡自冈算删孟制仑杯珊益盔盛偏
行	径征衍衔徐术街衙衡役后待得从复往很徊律卫冲
衣	依裁袋装裳裂制迎袭衷氏方迫哀
西	晒烟酒配酌酗酣酥曾醋丑医兵钾酷
串	患介川袖事亚而片佛拂沸芥界
位	倍亿垃拉泣仆立粒住培接焙暗音菩
住	拄注柱仆主位往蛀注驻仿依侦倍企禽
伴	倦拌胖畔伙半俏绊拳胜圈倘誊腾判券卷眷
佛	拂沸介仲费事伸喇串斗芥界例俐倒候侧
何	呵坷河阿奇苛荷倚可崎椅畸寄汽啊
估	做咕姑沽枯什个古固居苦仗胡湖舍葫
佑	知布倚俺仇蜘右矢智伺倍嫉裙吞吝君疾
伺	侵叼合刁浸妇扫司虐佑倍俭祠雪慧信哈倔伟超遣归伊饲
伸	呻坤神绅申仲畅介娄佛搂楼由甲屡篓
佃	偎儡个人每偶侮田仲伙伐休仙什仆位住伴估伸佣作你伯
似	以吆玄拗烁瓜畜药弧系幻叽机砾么乐关
但	倡坦袒伤旦查仁赶们昼替低悍捍杆焊汤旺旱
佣	用惫备内甩呐俱钠俘肉丙伴佃伙伐休仲件仙俏什仆
作	偏妒昨炸乍户仿仍伯件任傀肩怎窄
你	仔您乞苏癣伙仍鲜像侯伴佃伐休仲仙俏仇们什仆迄侈吃屹
伯	怕拍泊柏迫白帕作件任傀腺泉舶惶棉煌锦入
低	抵底婚只纸氏昏仁仰但系
伶	铃冷玲蛉龄零令侈吟侮偷伦俭今
布	怖希俺布币佑稀饰满滞巾倚啼棉瞒蹄锦席
兑	悦脱锐税阅蜕说兄况克祝嗅铝克息竞
克	兢克兄况兑古宫祝嗅悦脱圣锐固估咕姑居沽枯胡苦息税舔
免	兔勉娩挽冕晚冤逸挽竟色境镜眉息兄沉旭虎昨臭媚间媳楣
兵	丘乒乓岳西全合仁卸广具其真何汽仑伍舍哈恰拾拴
冶	始抬治胎冷冰台凛次冻准台苔
冷	伶玲蛉铃龄零准令冶吟侈次凌捻黔冰冻多今
别	刨划刷刮刹剖副判利删列刑刺到制削刊克则刚割创剩
判	半划削利删刺制刑刊刹割剩剂拳别刨刻刷到刮列剃克则
利	俐秃莉痢秧禾划刺制剩剿梨判删刑刻刮刊剃刹削克剔
删	刑刚册皿刺制划削判利刷刊刹则剖剩剂
刨	包克刚袍咆抱泡炮胞苞别划刮则剖副剩
劫	幼去势肋胁助动拗力男另勉勃功勒勘勋勤劝协咖
助	锄肋功勤且劲胁劫勃幼勘勋力男勇另
努	怒胁吴男勇另娱劣势肋奴幼茄荔力助劫协咖
匣	甲押钾曼闸卖申屡择泽浊独曙烛薯
即	唧节卿鲫印卸却既孵饵昂卵饲抑仰迎柳慨溉概脚铆
卵	孵柳卿铆即聊节唧留印傀块愧槐魄溜榴刘鲫鬼贸瘤
吝	文吞君紊右知各佑若癌纹蚊悯
吭	坑抗杭炕肮航哼返几唁般逢嚎嚷处蓬篷
吞	乔夭吝君各笑妖沃侨娇桥右知矫奏佑添轿
否	不杯示坏杯歪奈宗平炭祟票祭禁御灭碳燥
吧	邑把肥巴芭疤笆耙爬靶爸唱沪色
呆	保喳架噪棠口木澡燥宋床采堡品森藻吁林咪喇嗽
吴	娱怒蜈误努奴又吆叫吸唆碌
呈	圣逞任程告浩造望窖廷叭酷
吕	侣宫铝营呜兄呈叭召帅埠启克兑乌听咒呼招沼况哀
君	裙窘吝吞伊右知群各佑若匿癌杏吉台召品乔啄
吩	扮份粉纷芬氛分拐叨岔忿盆刀贫寡砌召招沼昭初盼剪
告	浩造吉窖靠呈售任逞酷程周丢廷淫糙
吹	砍歌欲坎炊钦欧久疚玖次亩欣软歉欢嗽灸
吻	物易勿忽惕锡踢赐匆啤必咆剔泌唬怠
吸	圾级及反各阁扳板返洛唆格烙胳略壳路客冬
吮	喊吠哺唬嗅兄咱唆唉叽咸茂息吵听吧吻吐吆咆呼况叨
吵	砂妙抄沙炒钞咪哨纱少劣京省炸苏渺
呐	钠内纳唯确肉丙佣吟吃哈喻咐瘸吹吐叭柄哨呛
吠	哭伏兽犬器献状默嗅突臭莽唉吮哺袱狱尤奖
吼	孔逊乳孤孩孙哼喉烹啊吹吸了弱桅脆唤危岳
呀	讶芽蚜穿牙邪雅鸦撑吁辱叮喂褥呵啄哑才
吱	妓技枝肢支鼓味咕歧求取哮嗜嘲吐喧口品娶最
含	今念令贪伐伶吟何俊捻铃仓筏冷伏代玲俯倚
吟	黔呛伶琴吃捻铃冷哈玲喻今
听	折析近所祈斩斯匠芹新斧掀嘶斤欣浙逝晰
囱	窗总因咽姻恩茵恼脑男肴傻葱
困	果捆棵困田裸木因回四囚围林栗尊森裹
囤	屯钝思趋盹纯腮吨匈困因回囚四田汹胸顿虑
坊	妨仿肪防房芳纺旁访淤游方游漩簇
坑	吭抗杭炕肮航坊返几般逢坛壕坏壤处蓬篷
址	扯企趾啃武止肯歧历岁遣步正垃怔涉赋逃症
均	钧匀志地勾勺灼冰钓芍址坏坷坪次的垢城冻准
坎	玖吹炊钦欢久疚次砍亩歌欣欲软款歉灸欺饮歇欧欠葵
圾	吸级及坡壳反扳板返各冬阁坎叛坑洛降格烙胳
坐	座挫雁锉难堆唯售崔推淮椎焦进集催锥摊滩瘫
坏	坪杯不示否坷平奈宗杯埂灭碳炭祟票祭禁御
壮	妆状庄墙将寝蒋姚王叫班址杜汪灶肚吐兆收旺枉北
夹	侠峡挟荚颊狭陕坐巫来疾卒疙座挫痊伞莱雁嫉锉
妆	壮状将墙庄寝姚蒋褥叫奸姊收兆北陋遣虫
妒	作昨炸乍户妨奶妖肩怎窄诈偏泪遍编邀篇
妨	坊仿肪防纺房芳旁访淤游方游漩簇
妙	吵抄沙炒钞砂纱少劣省炸渺妖妒如女奸
妖	娇沃夭笑妒添吞奏姓侨舔桥矫揍凑媳轿骄契乔
妓	吱技枝肢支妹姑歧鼓姥求取娶奸如婉嫁婶女奸最
妥	月女安采奸朋妻委妄争姜冗舀受肚溪馁
孝	字酵丈哮李存教季考学子好仔孕籽猛
完	宗元寇宣院三富二崇玩仁棕
宋	守未朱十妹味昧宇字栽案木株呆床安采穴森林
宏	太汰丈叉雄篡老者杖协仗宋安守穴寄十
局	巨拒炬凹凸加矩咖协架茄荔区渠距辟熙
屁	庇昆批比能尼呢尸花皂它化
尿	汇尸水取屈居尼屎屏泵泉屑展泰匹尾汞屋屠聚届匣沐冲叔
尾	耗撬毛毡毯牛毫刀扎解
岔	忿盆贫分芬吩扮份粉氛刀初叨纷券招沼昭切赖
巫	诬雁灵夹坐来丙卒蒙柄侠峡座挟挫准病荚伞莱锉齿
希	布怖布稀席肴巾常蒂币满滞
序	抒野予舒预豫多令墅侈爹矛移茅廊夕了伶
庇	屁昆批比能尸死花皂尼它化
床	栽梁乐厢戈药木烁戒宋呆采台专桨森林
廷	挺庭延艇蜓又任建呈浩造涎
弄	王珊班斑全汪玖旺枉玫玷理琳瑰
弟	剃涕梯第降引邢邦那防阱阻
彤	杉衫彩形彪彭彰影丹肪彬疹珍趁递谚射颜膨旁产
形	杉衫彭彤彩彰彪影邢刑澎膨珍彬疹薇
役	投股段殷般壳毁殿谷杀设毅殴疫后复彼
忘	亡妄盲忙芒氓茫荒玄民氏她志忠芯思恕恳丐慌
忌	己已怨息改危卷想范凹扼犯屈尼圈届纪桅倦脆
志	地应土均心忠吉芯思忘忍忌寺急怎恕恭恩息患闷惠感志
忍	监惠认慰式愚蓝篮代滥忌志忠芯思急怎感
忱	沈枕耽怖滞目巾惧相帽惯愤吊布冒买
快	决筷缺诀也弛她池地他柒心怯怕忙恨悄愧拖恢
戒	度庶席广械廉蔗戈渡遮镀床台弃
我	俄鹅义蛾仪牛饿找蚁牢牡件议失生毛抬
抄	沙妙吵炒钞砂拌捎纱少劣省炸渺找拍托扣扑扒扎挡撇手
抗	坑吭杭炕肮航扑投掠掖拥返几般逢搞摔擅攘搬处蓬篷
抖	扑斗科料魁拄拉蚪掉斜挤斟扯摘抗掠接摔
技	妓吱枝肢支歧鼓按丰捷撮求取拷控抖找抹扣扑扎挖拧手
扶	撵夫芙推替麸挫捧失拳拖拾拴抚窥找扣拌扑扒扎规抡
扭	羞钮丑纽扔抒挽拯揉换挺找拄扣扑打挂扎推疆挪手
把	吧肥耙巴邑芭疤笆捣爬靶爸捏扎色捍
扼	桅脆跪危倦诡已己配范圈掘搓忌卷范
找	抬挨拔捕搪拭掺撼扩我手戈扣伐扑俄扎
批	庇屁昆比能指揩砌化皂尼它
扳	叛板返贩洛降格烙胳略逢客疼
抒	序野舒予预豫多侈墅扭移矛爹扔挽投捻夕了茅
扯	址企趾啃武止肯歧历扑岁步正抖扛拉拄怔涉挤赋逃症
折	掀听析近所祈斩斯浙逝匠芹新斧撕斤
扮	吩份粉纷芬拐氛分岔忿招盆刀贫寡扬初叨盼砌券召剪
投	股役段殷般壳毁殿谷疫杀设殴毅没拨扳搬
抓	爬扒爪折拍托捷扳拆括捣掀插捶徐从搜播抑揪摊
抑	仰迎昂柳唧铆抵节卿御聊脚鲫捌印
改	己已枚收放牧玫故败启敞敢散敬敌数矢忌矣疾
攻	功工政汞巧项贡肛扛江收枚玫致叙敢数
旱	竿捍悍杆焊旦干杆肝汗奸秆罕赶旺轩橄是岸查但坦刊袒敢
更	便埂梗硬鞭由因抽油宙姻咽恩茵笛袖
束	速秉赖乘喇漱嫩嗽辣木中秃利枕懒癞
李	季籽字子好仔孝存孕学锰朵孟闲享厚林俘浮猛
杏	和木口杰吉台品森林枯程李吝吞否呆君告尚名召问
材	林才彬森村柏财栋槐闭豺淋板析株
村	肘林付寸寺守封射尉对森材栋辱专尊
杜	桂台木堡林枉柱椎土灶肚朴吐森涂
杖	仗丈枝枯末栖老者孝考林沫抹植酵宏茉
杉	彩衫彤形彭彪彰影彬疹珍楷穆材柏射槐才
杆	橄肝汗奸杆干旱竿杯枉轩罕本朽柄敢捍悍焊秆刊岸
步	涉止扯址肯企遣正武歧逃啃岁怔症趾遗
每	侮毒拇姆海悔梅晦母霉诲敏佃繁育个偶偎儡
求	救球支技妓吱枝肢甫术取圃歧述浦捕库哺脯娶
汞	工贡攻功江巧肛扛项筑红缸虹鸿
沙	抄妙吵炒钞砂消纱渺淡少淌劣省
沈	忱枕耽冲油津满湘目巾沸渊滞溃渺
沉	淫滔浮深净唬浑溪混滑号况洞息涡媳熄沮洗虎臭
沛	肺汁浦沽脖渤湖潮荸凄嗦甫
汪	枉旺王全狂涯汗污润弄皇闰班斑玖河江玫玷珊理瑰
决	快沐沫缺诀淋波筷渣漆湘冲汰沃污池汁嗓
沐	淋决沫渣漆湘水波污池林嗓木冲休汁漱柒梁森
汰	太宏淆雄叉篡沐冲沃决法汁淹滞潦水
冲	油津沈沸渊水中沐仲汁引川
没	投股浸段殷般壳殿疫役毁谷杀设殴又侵泼毅候涎淀夜
汽	洽沦何丁荷行海贮沧偷河打叮钉例气氨氧氮
沃	添妖夭笑泊凑吞奏澳活派舔侨娇桥矫
灶	社烧火墨土杜肚吐结炎灼牡炒炊炬炸烘祷尖少
灼	约钓芍的哟豹酌勾勺炮匀灶均钧火炎
灾	巢巡奸恼脑腊猎茎蜡
灸	久煞炊伙疚飞坎吹钦欠登发凳之玖次砍亩歌
牢	牛件湃宅牡犁看写我生失毛牧牲牵审物拜特
牡	特牛牧牲物件拜牢看牺湃我生失毛
狂	逛汪枉旺狸狗犯狠犹斑王全皇
玖	坎王吹玫炊次砍钦歌欢班斑欣玷珊玻亩理琢款欺瑰久弄
甫	圃浦捕哺脯补铺蒲博傅搏膊辅葡缚
男	另胁力肋劣勇因努茄荔劫助咖协幼加
甸	虑心肤田旬句勾勺卢匈匀佃苗思腮惯冀
皂	昆比庇屁白批能泉尼它皇匕化魄
盯	目打叮钉盹眼睡丁盼订眠睹了眨贮睬睛瞄
矣	疾挨埃唉矢枚敏蜘厂改知玫牧收致故救启敞敢散敬敌
私	禾和秋委香番科租秘稍稚秤秧秩秒栈稽穗利秃季黍
秀	透扔奶仍诱季乃委香孕番禾移秃私利和秒秋秘秩程稻秽
秃	利禾秧委香番季莉痢秉私和秋俐秀黍乘科秒租秘稍税稀稚
究	空突帘窄窗夷九姨胰仇穿窒穷窘轨
系	丝累紊素索絮紫系哟细紧繁罗蕴纠约纪系纱纹纯纽纳
罕	肝旱竿干杆汗奸轩橄岸刊捍悍焊杆敢
肖	尚削俏消捎悄峭屑宵哨梢堂棠敞掌当销常稍硝党
肝	杆汗奸干罕旱竿轩橄且同肛胚敢捍悍焊杆刊岸
肘	村付膊寸寺守封射尉对将采耐博傅搏辱专尊
肛	江扛缸红虹工筑汞攻功鸿巧贡项隐稳
肚	周角月塑朋周土台灶杜吐台
育	朗母流梳澈撤琉硫帜职每有胃舟朋拇姆疏彻织辙识
良	食浪娘狼琅养痒餐恨退根痕银宴
芒	荒茫亡忙忘妄荠蓄慌芳盲
芋	宇某于迂污吁甘媒煤芽苛华五途
芍	芯葡灼钓苟的约勾勺苞菊豹酌卜叶蕊匀
见	觅规现视砚窥觉能搅观比
角	触嘴肚周勇涣换唤焕台痪负丑周解塑
言	这信唁计三答二石订记讨讯诀许讼注诅诈
谷	俗容浴裕保钠锥钥蓉却欲铅铃溶熔榕
豆	岂痘逗合登丰同石哎短壹喜哄碰碘磁
贝	则财败贴贼贿贱贩贮赔账赌赚赠员贬赂赊赐购赎
赤	赫赦吓亦斗小到奕倒划前迹
走	赴起越赵超赶趟趣趁趋陡徒足垃卦进迄坊坑址定夜卒玷是
足	趴距跟践踏踩趾跋跑跌跺踱蹂蹈蹦
身	躬躲躺躯穷臼儿舀焰滔凿与姊陷舅鼠稻桩
车	轰轧轨轩软轴较辅辐辑
辛	辨办辣辫瓣辩宰锌辜辟滓辞僻避薛立
辰	唇振晨震三韭甚农污夸巧堪二浓脓
迂	污吁途于芋宇上五逐除这逗逼卡言某柴
迅	汛讯通卜筑迂返迫述送逆迷退回连速进逮逢逸斗
迄	屹吃疙乞夜途逾乙挖液掖腋进旋跪蹂你仔函卒
巡	恼脑腊灾猎巢蜡妄奸亡玄茎
邑	吧芭疤笆巴把肥爸耙爬唱靶色沪
邢	邓郑邦那邪郎郁部邮刑郊郭都鄙
邪	牙雅鸦呀芽穿蚜邢讶邦那郁郎郑
邦	梆绑丰那邢郎郁都邮郑椰邪郊部郭
那	挪娜哪邦邻邢郎郁郑邪郊部郭都邮
里	黑埋哩里墨狸理量童嘿野畦重撞鲤钟
防	妨坊肪仿芳房纺旁访淤游方游
阱	隘并拼队阻限陌耕陈并井屏防阿阵陡陕隅饼
并	普碰共并井供并哄屏拼拱洪恭烘基异
乖	千忠妻卑乘吏朱舌宙患燕事垂盾重使刮恬括段活株刊
乳	孔吼脆了岳孤孩孙弱乱桅危仙扎预儿股侯溺逊
事	拂沸佛串斗喇费妻患介梦吏宙前划刊涮袖川
些	三柴紫二仁言票贰疟嘴奈宗岸底完夸祟祭禁御严式
亚	恶哑串片工要栗患介粟栗腰迁融而虫正斤止版汞肛兆
享	烹游淳京亭亮厚高豪子郭敦毫荸膏孽俘哼浮游谆醇
京	享亭亮高烹豪景膏掠凉晾毫占逞吵咪哨鲸
依	袋裁衣装裂制仿袭仆裳位住迎
侍	恃持时特待等夺诗傅传寺付封对咐府符
佳	娃挂桂畦侥卦蛙鞋挂褂闺封涯崖
使	吏仗什估史午仲值做妻伞便侠佛佃伸伙伐伊伏休
供	哄拱洪烘仆共异并港恭基寒塞寨暴
例	咧列倒俐侧殃歹尸毙死殉残捌涮喇测何殊侈汽
来	莱坐夹巫枚椎卒侠峡座挟挫栓荚伞雁黍稚漆膝
并	拼并井屏阱耕供饼借沟构
侈	移多爹令麦伶铭舞杰夕宛铃外名梦
佩	筛狮师俩跺枫飒肌毅咒冗讽飘饥凯股布投段殷般壳殿躲
仑	伦盒抡沦合偏拿愈会盏尽瘟册皿偷仁命盆盖篇卢蓝篮温
兔	免冤勉逸娩挽冕晚挽臭竟嗅境镜搀
儿	身躬臼躲穷躺息舀躯先兄虎沉臭焰媳滔熄
两	俩辆雨巾师佩筛霍吊布雪狮漏际
具	俱其直且值期棋植二箕姐宜沮冠欺
其	期棋箕旗簸具甚甘俱堪二某柑勘斟钳广
典	碘菜罕散共前探深蒙撒金月脱煎荤喷坟愤箭蒙
函	涵乙乞疙迄吃屹挖水山弓门夷色斗出永目凶丑屯巴支久夕子
刻	剧咳核孩制利剩剑剂该骇亥刺刮判删刹削剖刑划
券	卷招半拳分眷圈刀初倦叨忿岔沼判叛昭绍切
刷	涮刺制削则别删划刚划到刮刹剃判利刨列刑剖副刊剩刘
刺	制削刷棘枣利删划刹则判刚刑刊剩剂
到	至倒致列划室屋刑副刊划握窒
刮	舌甜剖割舔创恬括活制别利刨克划副刊剩
制	刺削刷删利划剩刻刮判刹剃克则刑剔刚刊剂向奥
卒	悴率碎粹伞醉从什翠午进褒夜来坐夹巫迄途遥
协	荔勒胁肋力男另劫助勃动幼咖办勇茄劣
卓	悼掉罩绰早桌草章昧退樟斗暑腿障潭褪
卑	啤脾碑千牌朱舌勿笑
卦	挂褂封佳娃挂桂畦赴涯崖闺垃蛙鞋坑走洼
卷	圈倦券半拳眷危已己判纪犯
卸	御丘即却印岳乓乒仰脚蚯迎抑柳唧铆孵兵命昂节
取	耳耻耿聂趣耽茸娶最撮聪职支揖聘联聊丛闻
叔	淑椒寂督迷乌鸟取冰呜坞鸣水尿冲沐汁鸠
受	爱朋崩授棚骨硼鹏滑觅月乱腺
味	妹昧未咕吱宋哮朱嗜嘲呆守咪吐吁株朱喧口品
呵	坷河何阿奇苛叮啊可倚崎椅畸寄荷
咖	另茄加胁肋力品男嘉助劫幼勋协勇架劣荔
咕	姑沽估枯古固居苦味吱胡湖葫做糊
呻	坤伸神绅申畅娄搂啸楼由甲屡篓吊
咒	殴冗器哭单嚣几肌设凯跺朵疫严疯佩股吭投段殷般饥壳枫
咆	抱泡炮胞袍跑苞饱包雹刨句
呼	乎窃蟋悉咪叭释米咱听啤呜鸣呈
咐	附府符付侍树傅传寸喉吟恃持俯时砖蹲等夺厨
和	程禾私秋委香番科租秘稍稚杏秧秤秩税秒利稠季秃黍
呢	屁尼能批昆庇比匕尸
周	肚吉周同碉稠绸告售结膨雕
命	合拿盒仑登会砸仁俭答哈却恰拾洽凳合签仰捌脚僵捡检
固	个古咕姑居沽估枯苦胡湖葫做糊
垃	培境拉泣位立粒倍接焙暗音菩陪亿撞樟忆钟
坷	呵河何阿奇苛可倚崎椅畸寄荷啊
坪	秤坏评平萍不坷杯埂否示均址垢堵坝土
坡	玻披波被疲彼破跛皱皮菠板颇圾格簸
坦	场堤但袒昼查旦塌书悍捍杆焊汤坛旺旱
坤	呻伸神绅申畅娄搂楼由甲屡卖篓埂
夜	迄掖液腋候健又侵假寝没般暇霞只双疫股返投段殷浸奴
奉	捧春泰棒奏秦揍擎蠢凑榛桩拳击挟摹手抛掩捺撩
奇	苛寄坷呵河何倚崎椅畸阿可骑
奈	宗祟票祭禁御夸示捺左痘三二不碳炭崇否斋杯坏仁棕灭
奄	庵俺掩淹布由希宙笛抽油袖迁
奔	寞奢莽寒塞寨瘩大希豆痘痰痪宽瘟
妻	凄栖安吏宙耍妥奸娄事乖使捷委姜要妄娶案女刊数
委	禾香番萎和秋私矮季秃秀黍利科秒租秘稍稚
妹	味昧未姑妓宋姥朱婶守好她如奸株婉嫁女奸
姑	咕沽估枯古居固苦妹妓胡湖葫做糊
姆	拇每毒母侮悔海晦梅姻诲霉敏育妨娘如嫡流
姐	沮且宜阻祖租粗组蛆诅锄
始	抬治胎冶苔台台或怠域结铭如吆名
姓	性牲星笙产生腥甥猩铲妖妒拜猜隆醒牛
姊	肃啸锈萧箫姓妆妒妨妖妙如奶叫嫌绣姚身女奸
孟	锰猛栅子盅扁盈杯益盔盗盟监册皿
孤	弧孙狐瓢瓤孔逊瓣孩瓜吼以似
季	李秀籽禾委香字番移孝秃存孕学子和利私秋好仔
宗	奈祟票祭禁御完示崇棕宣察富三二不碳综
定	是锭绽堤提宇家下室士匙寇宗完宣富宾
官	管棺馆宫古刮宙居宋苦安吊穴唐舌十姑固咕沽估枯胡
宜	且姐沮直真阻祖租粗谊值组蛆植填慎锄镇
宙	笛轴由抽油袖聘娄申
宛	多婉惋腕爹侈移碗麦夕舞铭豌
尚	掌棠当堂常党尝裳赏肖当哨膛挡档裆铛宵屑削俏峭悄捎倘消梢
屈	茁倔掘窟出拙尼届己已微忌屁祟凹
居	苦古姑固咕沽枯估葫胡湖锯圣耳做糊
届	屈尼己已忌凹屁尸呢倔掘睦
冈	钢岗逆纲溯册皿刚血栅盅茁膜
岸	炭祟岂崖三二干悍捍杆焊旱竿杆肝奸汗仁秆干赶
岳	丘乒乓卸兵全元合光仙蚯孔仁乳御
帘	空吊布帝突究窄巾穿窒窗币窃窝帅
帚	妇扫带归刁帝寻蒂而叼啼耍虐雪需慧巾侵伺浸
帖	帜巾沾幢帕玷站贴占店帆帐点幅雨
帕	帆腺巾怕拍泊柏伯迫棉锦帖舶绵白帮
幸	报择泽绎释译辛毕弄苦
店	惦占沾帖玷站廓贴点台图储京外诸
府	符咐附厨俯付侍寸傅传冠蔚等夺团恃持时博搏膊砖
底	抵低只纸婚氏昏或些
延	涎诞廷又建挺庭桑奴蜓狡怪股投没侵浸般候假健暇艇狱键
弦	炫舷玄畜蓄吆以幻乐纤烁弧幼似亡几药关
弧	孤狐瓤瓢瓜瓣以似弦系系虱孙吆幻县玄乐关悬
往	徙很徊律徒征待彻征彼循徐行从
征	怔症歪行整往律徙很徊徒径徘正彼政循徐得衍御街
彼	被披波坡玻破疲跛皱役后往很徊律循复皮
忠	患中袍心芯思志燕乖乘川忍急怎忘忌盅恕恭恩息闷惠感陶儿
忽	勿易吻惕物锡匆赐踢必剔态恳惩筷怕泌豹愧
念	今含令贪捻伐伶吟代俊铃愈筏玲冷伏俯黔
忿	岔盆分贫芬扮吩份粉氛刀初纷叨券招沼昭切赖
怔	症征歪正整政止扯址遣武肯企歧恒啃逃步
怯	法去恃盖劫磕丢玉勾勺愧心
怖	布希布恢惰稀满滞巾棉啼瞒锦席币
怪	奴又挺庭只双廷涎健蜓键没建候艇夜坚
怕	惶拍泊柏伯迫白帕愧腺泉舶棉煌锦必
性	姓牲星笙产生腥甥猩铲怕拜愧情猜隆醒牛
或	怠台国域苔名惑抬治始胎底吁叮三感冶
房	芳旁肪妨坊仿防簇游方纺淤游访漩
所	匠析近折听祈斩斯芹新斧掀斤欣断殷浙逝晰乍户房
承	夫了芙扶替失推麸予拖牧拾拴没挫规孔抚击
拉	接撞泣垃位啦扑立粒拄抖挤倍培焙暗音菩
拌	伴胖畔半拳抄捎绊倦胜圈誊腾判卷券眷
拄	注柱住扑主拉往抖蛀驻挤注扯掉摘抗掠接撞拥
拂	沸佛费事抽喇串斗搂捌揣掀患介梦
抹	沫末茉拣披枝杖枯抖技找扣扑扎手抽押拙拍拘拉拌拒拄拓
拒	炬巨矩距局凸凹招掘找扣扑扎握摄挪手渠
招	沼昭绍超券召拐扮叨解初刀分赖切忿岔
披	波坡被疲彼玻破跛皱皮扳菠板颇格簸
拓	拾石司打泵害砂研砍扣扛硝歌恰洽哈搭瞎捡割硼
拔	跋发找犬捕搪抬挨吠伏拭撼拗
抛	胁锄胜渤勉力劳筋肋加务踊男努另
抽	油袖搂由宙笛轴拂掩聘申娄
押	择钾甲匣摆曼闸卖搂捆拇泽浊独曙烛申薯
拐	扮揖叨招吩捐扣份刀召粉纷损砌捌芬沼昭扬初氛券剪分
拙	扎掘出屈茁撬倔微指摧揽批甩毛祟窟
拇	姆每毒母侮悔海晦梅押诲霉敏捆找扑摔撤育
拍	怕泊柏伯迫捣白帕托扒腺泉舶指揩惶棉煌锦
抵	低底婚只纸氏昏拭抑
抱	泡咆炮胞袍苞跑拘饱包雹刨
拘	抱钩苟狗驹够出句扣包拓泡咆找炮胞托扑袍扎掏手苞
拖	施他拾拴捻也抡舍抢捡擒弛池她地抚扶推驰夫
拗	幼抛劫似锄吆胜胁玄渤幻叽机烁砾力畜劳筋势药
拆	诉斥折拍托扒浙掀逝下扳抓括捶捣哲扑插抵提播排揪撕
抬	治始胎找撼冶挨苔台掺扩台搪或怠
放	族于邀敷方施旅旋旗激簇肪妨坊仿淤缴房芳
斧	芹析近折听匠斯所祈斩斤掀新父欣浙逝晰撕嘶
于	施旅族旋旗放方淤仿肪妨坊邀房芳簇
旺	皇枉汪王全闰狂惶煌旦弄凰蝗班斑旱量
昔	萌莫芭音草墓暮摹慕借措惜错意募葛幕蔓暗
易	吻惕锡物勿忽赐踢剔匆必昌泌
昌	晶倡唱猖日间昔旦暗旱春冒音香旨书曹暑
昆	庇屁批比能皂混棍花尼它指脂化
昂	迎抑仰节唧柳铆昨即印卿御聊脚鲫
明	冒萌暖日晕朋月昌晶盟厌旺映昨昧胡晌朗朝晴帽
昏	氏婚只底抵低纸旬
服	报肾候坚股捌胀胳腋别脚斗又争前紧竖贤
朋	受棚崩爱硼骨授鹏月肺乱滑明肚觅肥肢胖胡肝肘
杭	炕抗坑吭肮航朴返几般逢檀枫朵处蓬篷
枕	沈忱耽相柿目巾秧棉楣湘束厢箱林楼帽睬榄桃困柜
东	栋柬冻陈棵番拣炼田木潘播审
果	困棵裸裹捆颗巢田木尊困汇课
枝	肢技妓吱支歧枯杖鼓末栖求林沫抹取植茉
林	森淋材村栋琳彬木棵焚杜沐朴休李
杯	坏不示枉杆否秤本柄朽棕平宗奈杯禁
杰	焚秋梢木秒炎火揪锹杏灰愁森林杯稍档
板	格返扳叛贩洛烙胳略逢客疼版饭降峰路锋皮反
枉	旺汪栓框王全狂杯杆琳弄皇闰班斑本玫柄杜玷珊玖
松	钱公蚣栈讼贱粉械镀浅铅林梯铺木森松
析	新近折听所祈斩斯晰芹匠斧掀斤
枚	叙教敦矢矣疾牧玫故改收启敞敢散敬敌数
欣	掀斤析近折听芹匠炊所玖砍祈坎吹次斩钦斯歌浙逝晰斧
武	企赋扯址啃历止趾肯歧岁正鹉症步怔遣沥
歧	止肯岁扯址企枝肢技妓吱啃武趾鼓
氓	眠民亡忘妄盲忙芒娱茫荒絮
氛	芬份氨氮扮吩气氧粉氢分纷忿岔寡氯
泣	拉垃位立粒注沾济倍接培焙暗音菩
注	拄柱住主泣沾往蛀济注驻滴淑涉卤流凉滚漓
泳	咏漾永样浪浦治浅渡涵泛河法沸沐汰冲汛
泌	必秘池密泡汹勿瑟蜜怕愧柒泥泊沐沙沃冲吻汁
泥	沼急怎泌沐冲池汁浸滥水范
河	坷呵何阿奇苛可倚崎椅畸寄荷啊
沽	湖姑咕枯估汁古居固苦活沛胡葫
沾	占店帖玷站凉注泣贴济点淳
沼	招昭绍超召叨初刀分浩解赖切忿券岔
波	披坡被疲彼玻破跛皱菠皮板颇婆洛格簸
沫	抹沐末茉决淋汁波枝枯杖渣漆湘沽沛冲汗污汛池
法	怯去盖劫磕丢玉涛注汪汰沐冲淮汁
沸	拂佛冲费事油津渊涮喇串斗沈测
油	抽袖冲由宙笛津轴沸沈渊淹聘申娄
况	祝兄竞克兑悦脱锐沉嗅洗税克阅
沮	姐且宜阻祖租粗洞组蛆诅锄
沿	铅浴治船沼洛浩涡溶铭澡锅涕铝水品谷
治	浅抬始胎冶渡苔台渗沿台或怠
泡	抱咆炮胞袍苞跑饱包雹刨
泛	眨贬乏之芝洛泪澄漱浩添漾泼潘澳泳泊沃饮久么
泊	拍怕柏伯迫白帕腺泉沃舶源棉惶煌线锦
炕	杭抗坑吭肮航炫返几般逢缝处蓬篷烙肌朵冗
炎	痰淡炒氮火毯荧谈杰灰尖少燃灸羔鱼焚焦无然黑荣灶伙
炒	纱沙抄妙吵钞炎砂少炸淡痰省劣熄渺
炊	灯坎吹款钦久疚玖砍次亩歌灸欣欲软歉欺饮歇欧欢欠葵
爬	抓肥把吧靶笆耙芭疤邑爪巴爸履艰复
争	筝净挣狰睁静采凸胀妥月服朋舀渠冗受肘肚肋
爸	疤父芭邑笆巴肥把吧斧耙爷爹爬靶色交
版	牌片牍板返扳降叛隆贩饭洛烙格胳略逢蜂路
牧	牛枚牡启玫放牲故改收敞敢散敬敌数矢失矣疾
物	吻易勿牲忽牡惕锡牛牧拜特赐踢匆看
状	妆壮将墙吠伏庄寝默献蒋兽虫犬突臭哭莽奖
狗	拘钩狂狠狸犯苟狐狡狼狭狈够犹驹猖猿狞
狐	弧孤瓢瓤瓜瓣狠狗狂狼狭狸犯
玩	冠寇琢班斑王玫玷珊玖珠现理琅球顽琐瑰琉
玫	致斑王枚玖敢珍玲班牧玻玷珊政故改攻收理
疙	迄屹吃乞痊乙疹疮挖奋疾痪夺夜函侯你仔猴
疚	久炊坎吹钦灸玖砍亩次歌欠葵夷九欣欲软歉
的	白灼钓魄豹泉芍约酌皂皇泊拍怕柏迫伯
盲	亡忘冒妄省眉看眷督目相算芒望荒篡氓忙渺惧
直	矗值植殖置宜具真且俱慎填二镇肺沮姐沛冠谊
知	矢佑矩蜘枚短矣疾智唉矮矫右吝吞君
社	祷灶祖祥结祈祠神祝视福祸绕续
秉	束乘禾秃利俐秧莉梨痢委和私秋香犁速番
空	窒穿控腔帘突究窄穴窗洼窖窘窟窝窑
纠	丝细绿绣红纪约纹纯纽纳纸纱绊绅组维
者	煮都屠奢堵着暑署睹诸绪赌薯曙储
肺	脖沛脯肢朋荸朝嗦甫腔膊宜军索囊肝肚浦捕哺补铺腕潮
肥	把吧巴芭疤邑笆耙爬靶爸色朋
肢	枝技妓吱支肺歧鼓求朋取腔军肝肚脖腕月受娶最
股	投段役般殷壳毁殿谷疫设杀殴毅肌冗没胳
肩	扁乍户怎房雇篇偏遍炸昨妒作盛所匾编蝙
肴	有希淆贿学郁肴疾灰布左觉瘸疗大
肪	旁妨坊仿防膀芳房纺访傍榜淤游方游
肯	止啃歧岁企扯址武趾遗步正遣青背症贵历怔逃涉将赋
卧	临臣宦藏赃坚肾脏鉴紧竖贤盐除附仰袱爪涤
舍	舍估合干全古干个舒拿丘何做仁俭居苦竿旱命仑盒答会沽
芳	房旁肪妨坊仿防游方纺淤游簇访漩
芝	乏之泛眨贬茂久茅欠荐苔莽葵饮疚灸蔗炊坎吹次钦
芙	夫扶替羊失麸撵差窥洋推
芭	邑疤笆昔巴肥把吧爸草耙靶萌莫爬色借措惜错
芽	呀穿蚜牙讶邪雅鸦芋辱茎撑褥苛华葬才
芹	斧近析折听匠斯所祈斩新斤掀薪欣浙逝晰撕嘶
花	靴化昆庇屁讹批能匕比尸荷茶呢匙
芬	氛扮吩份粉剪分纷忿岔盆寡贫刀拐召初砌盼叨
芥	界介串佛茶仲患花梦蕉芜芝芙芹芯昔苗英艾荚莱
芯	芍苟蕊苞菊萄叶恭葡卜心昔忠苗志思艾遂
虎	唬号递虐虚处虏肤虑彪媳熄息密卢嗅钻
虱	强虫闽蜜蚓蚤蛋御风蚊蚪蚌蚣蛀蛆蚯蛙蛔
初	叨赖刀分切沼招昭忿券岔召解盆拐扮吩份绍超绝懒
表	表素青畏长生拓差打辱害清情偎晴喂
轧	轰车轨轩软轴较辅挽辆辐辑
迎	抑仰昂柳唧铆衣衷节卿聊御脚鲫依褒
返	逢板扳叛疼贩洛胳烙格略客处
近	析折听所祈斩斯新芹匠逝斧掀斤欣浙晰
采	菜肘采膝荣月睬争木床宋妥呆枣桨森林朋棘踩
金	针公四匹穴共只父六小铅谷钉钓钞钮钠钝钦分钳钾
长	张胀帐涨账刁畏叼表司虐伺辱偎喂
门	闪问闲间闷们闭闰开闸闺阀闻闽合涧阎板简关
阿	啊河坷呵何奇苛陌可隔阻陋倚崎椅畸荷寄
阻	隐沮姐陌际瘾阿阱限租祖陈蛆粗隅且宜
附	咐除府符付险阴侍传涤隧陡陕陈傅褥夺
雨	雪霍云零震霉霎霜霞霹灵
青	责清情晴猜靖睛精蜻毒素债请静积擂
非	匪排啡菲徘罪诽靡悲靠辈兆北
亭	高豪膏毫停京享亮烹宁嚎蒿篙逞搞壕镐
亮	京亭享高毫豪烹膏充逞秃占儿常哀吊图允啸选
信	这唁警誓誉譬言谅停谆让计谜仆讹
侵	浸伺候假夜寝殷股投没殿叼健段般妇役扫设壳毁毅殴谷暇
侯	喉跪猴桅脆诡溺你仔天危乞侈佑布杰弱仍健佩夜疙
便	埂梗硬更鞭俩伸何伍俺伦偷仁僵价俭由命全合
侠	峡挟狭陕荚夹颊仇佑俭矢伞侮伦伶布偷从伤
俏	赵倘哨峭悄捎消梢销偿伙肖宵屑硝稍伴尚
保	呆噪谷堡棠俗杰澡燥休佑喳操躁促侣褒
促	捉足趴距跟践踏踩趾跋跑跌跺踱蹂
侣	铝宫吕营促呜保俗谷俄帅依倘佃何作伯估
俘	浮脖仔荸子厚享学偷酵好游李字游
俊	唆峻梭竣酸骏傻俯凌锋贩伐反念含菱令今
俗	浴裕容豁谷份保溶榕熔却欲蓉僧仆脚
侮	悔海晦梅诲每霉伶母伦偷俭姆拇伤毒
俐	莉痢利倒例侧梨喇秃捌揪锹秧矮秉犁
俄	蛾饿义件仪我傀鹅作伯任蚁牛系找议入
系	孙县逊系仰细傀低洁似累悬俄纪约依纱纹纯纽纳纠作伯绊
冒	眉目相帽省看盲眷明督算篡渺惧厢萌箱贝自盹盯眼媚
冠	寇玩府符肘膊厨蔚元等恃持侍咐时院将诗褥
刹	则划剃削刺制判利删别刑剩刊刘剂克刷刻到刮剖剔刚剥
剃	弟涕梯刹剔制利剩削则刺刮刷删判列划刑刊划剂
削	刺制刷肖删判划刹则刚利剩刑刊剂尚
前	荆莉煎剪箭涮厕斗痢菜侧测蒙削俐咧刺制例倒
克	兢克刨刚刮制利剩刊削则刹刺剖判删别副刑划割剂
则	贝侧测厕刹财败贩贴贿贮贼贱账赌赚贬赂赔赠赎
勇	肋踊男另筋胁痪唤换涣焕努劣势劳力助励
勉	免兔娩挽晚逸冤冕挽胁劫助肋幼勇劣
勃	渤助肋胁劫勒幼协脖勇荸勉勘动勋功勤励咖
劲	颈助功胁勘肋勤幼茎勒劫励径经轻氢男另
南	册皿栅盅肺沛幸甫毕辛血冈扁珊杯苦仑孟宜宰益
却	脚欲卸溶榕熔蓉即印俗浴裕命容谷
厚	享子荸游闲俘浮孽李闭字脖好游仔
叛	扳板返烙贩洛格胳略逢客疼
咬	校狡绞较饺交郊效嘀六父咳呜吭
哀	远园逞猿袁辕衷褒京衣占迎亭亮享高毫禀豪
咨	姿资瓷次嵌久丁保吹冶叮疚否问售灸名台欠谷登可之
哎	艾哗咽诺苏哄豆唤若嘉送叹茄匿
咸	威喊减合灭戚同后茂垢咸害拿岂言豆富痘石
咳	核该孩骇刻亥叭咬趴呜嘀吭唬拥嚎嚷亡
咽	姻茵哩恩因喂嘿男吠吐当囱更口品当
咪	迷米屎呼磷哨吵粥粱气籽料粒粗怜乎京粟糜
品	噪区呕咖癌澡燥嚷板口岖枢操躁
哄	嘶拱洪供烘共异谱港恭基寒寨暴
哈	恰拾洽给蛤答合喻俭捡检脸钥喊合吟吃呛险石签
咱	自瘪边首省眉算叭道媚楣目篡
咧	例列喇殃歹尸叮毙倒捌殉死残
垂	邮唾捶锤睡甘千某柑甜钳卑朱舌奔芋媒虚煤
型	荆刑删斗坚基墅前莉丑邢烈荐羞开塑涂闹萧压痢
垢	后块减喊石咸坞埠坷拓塔泵壹筒答司碧
城	诚成盛坊乍户塘去昨炸妒作埃域蝙怎茂肩
垮	胯夸跨愕夸捺污堪巧亏朽奈
奕	亦迹赤斗小赦痢交父症奠尖艾闹前荆莉市
契	楔夭奏笑吞拍妖扳沃托扒尖艾奥美哲劣大叛括拆折
奏	揍凑秦春奉泰笑夭妖沃榛桩矫添吞侨舔娇桥
姜	美羔义善对羹窑糕膳妥安奸漾仪样牺
姿	咨瓷资次嵌久丁疚灸欠氨之砍准欣炊钉坎吹玖冰钦叮打
姨	胰仇夷九轨旭究友丸嫉疚姻妖好如奴鸠为女奸染
娃	挂佳桂畦卦蛙鞋挂褂闺封涯崖
姥	老妹姑妓丈杖仗姨姻妖她如奸奴婉嫁婶者女奸怒
姚	挑桃逃跳兆北妆啡排壮遣溃遗
奸	妄灾巡巢女妥安茎如姜妻委宴案姨娃姻
威	咸喊减灭戚茂成衰岁表长后斥斤奸城畏竿底
姻	咽茵恩因姆男姨妖如奴囱更女奸
孩	咳核该骇孔孤孙刻吼亥
宣	喧宗完富旦喳渣量宾三宇宿百士
宦	臣卧藏临赃坚肾鉴脏紧贤盐竖宙官家宋寓安穴屡昂节聂
室	屋窒至倒致到握致宇定家士蛙
客	阁洛格烙胳略络赂路各酪骆疼板返扳逢
封	对寺卦村肘付恃持时侍等射尉特寸守夺
屎	米咪迷粱屑气粥粟慰糜尉蔚乎籽料粒粗怜磷
屏	并井拼并展耕阱沟构并饼购
尸	毙死屁庇昆歹咧例呢能批
屋	室窒握至倒致到致套刁蛙司肆
巷	共恭基撰选益异拱哄洪烘供起斯港
帝	蒂啼缔蹄吊布帘币巾旁帅敌离献
帅	吊师启巾常布帝帘筛狮币帖帕怖埠布啼棉满锦
幽	滋慈磁朗几吆玄以幻乐炫郎弦始晋畜参浅似栈
度	庶戒席广渡镀械踱蔗廉范茫藻盏萍蒲荡戈遮
建	健键肄又津廷笔律延肆奴桑怪没候夜只双
很	徊律往得限徒征彼徙循待徐从行征
待	恃持时特侍得徒等徐往后从行诗很徊律街征
徊	很律往徒彼征徙循待徐从行征役得德衍御微衔衡霉
律	很徊往征徒徙徘彼循待徐从行御征
后	役复彼待行径徐凌得从陵傻很征
怒	努吴娱奴蜈恩又误悠怪思急恕忠芯只志您忘闷双惩夜
思	囤腮虑田恩葱心胃忠芯志急怎畏恕恭息忍患忘忌男
怠	或感台憾撼苔名胎抬始治惹恕惑冶品国戈咆域吻
急	怎泥思怨忠芯忌志忍闷怒恕恭恩息患您忘惠感闻慰心耻
怎	乍户肩扁房雇急昨炸妒作所窄成方乃殷
怨	鸳忌息急想凭己已夕怎忍闷惠多名危感宛纪桅侈脆惋
恍	晃光幌辉悄耀元恒性忱怜心岳完
恰	拾洽哈给蛤答合愉俭捡检脸钥险石合签
恨	根退银痕狠限眼旬很跟艰腿褪堰良
恢	怖灰痰惰燃憔然淡懊心尖煞
恒	懦且需怔慎情儒姐沮悟惰愉糯宜雷
恃	持时侍特待等诗寺夺封对寸将博傅搏传膊砖褥遵怯
恬	括活话舌刮甜舔刮阔怕愧古千恤性必管
恤	血懊怕愧皿册盆恬性必荡栅扁盅向奥
扁	盛篇偏遍肩编蝙乍户匾怎盅监盈杯房孟益盔雇盟荡皿册栅
拜	牲牡牛牧物生性姓特星看笙件腥牺湃牢产
挖	控迄屹吃腔乙疙麻按拧空究窟乞
按	安鞍拧擦技丰案控接氨挖捷拷湃手奸宴
拼	并耕并井屏阱拱饼措描沟构
拭	试式抵腻代找贰拯抬控搓撼挨扩
持	特恃时侍待等诗搏寺夺封对寸将博傅传膊挠砖褥遵
指	脂批旨能比昆庇屁揩化匕尼它
拱	撕洪哄烘供扑共异拼港撰恭基寒塞寨暴
拷	烤铐考技捷按丈拉拄抹拒抖杖扑仗挤挖控拧拢丰
拯	蒸拭控搓抵揉换极担扭扼扔永拾拴捍抗授涯搔仁拨擂
括	恬活话舌刮甜刮插捶舔阔拍托扒古千拆扳折抓捣管
拾	恰洽哈捡给蛤答拴舍合抡搭俭拓检脸钥拖抢险石合签
拴	栓痊拾舍抡捡全班斑拖王玲珍捻惶抢煌润擒推
挑	姚桃逃跳兆排北啡遣溃遗
挂	挂娃桂佳畦挠卦蛙鞋褂闺封涯崖
政	正攻怔歪症征整玫收敢敌数故致效放枚牧启叙改敞
故	做启敬古胡枚敢牧玫改教救收敞敦散敌数敛矢疾矣
施	于旅族旋旗拖放方仿他淤肪妨坊房芳簇
既	慨溉概潜即蚕唧节卿鲫畏蚜冰偎喂馁褥旷表长
春	泰奉奏秦蠢捧棒疤昌痕暮者揍凑榛桩昔暑替晶
昭	招沼绍超召叨照初刀分解赖切忿券岔
映	秧英殃央鸯棉锦巾明绵然吊布
昧	妹味未早宋朱卓草暑守明株日昌晶
是	定提堤锭旦匙绽旱下题旺昌晨查量晒坦但袒
星	笙产牲性姓腥猩生醒甥铲牛拜猜晴隆
昨	炸妒作乍户怎窄肩诈泪偏遍邀篇
柿	闹市朴柱枕巾校棉林核杭梳榜椒帝吊布
染	孝朵闲夷九子哮李梨姨胰教旭仇柔架柒疚采梁床宋究呆
柱	注拄住朴主往蛀注驻柿校杜核林梳杭椒
柔	揉蹂禾乃香委梨笨番策箱秉秋和私采床宋呆朵闲孕森矛
某	甘媒煤芋柑钳谋于虚宇嵌五甜迂污吁
柬	拣炼练澜拦栏烂兰东栋畔鱼棵番
架	贺驾呆加茄瘸咖力嘉男另保喳肋
枯	沽姑咕估糊古苦居固胡枝杖棺湖葫
栅	孟皿册盅珊锰相猛扁杯益盔盟监棚盛盗
柄	病陋丙杯枉杆内朽本林梗呐钠极檬橄
柑	钳棋甘媒煤某甜桦横虚酣谋嵌朴林槽模檬芋
查	杆杨昼旦坦但袒渣秆喳香根粮旱旺
柏	棉迫泊拍怕伯白帕穆材槐腺泉舶惶楷煌锦才
柳	铆聊卿榴留溜瘤迎抑御仰刘贸唧脚孵馏昂节
柒	池也柴泌沐快弛她地他采梁床宋呆森林淋
歪	症怔整征正政杯否不止武肯企胚扯址遣
殃	映列歹殉秧死英殊殖残咧例央歼
段	殷股般投役壳毁殿谷杀设毅殴疫锻缎没击
毒	每拇姆母素青侮海悔梅晦责霉诲宪面害清敏猜情晴甥睛
泉	白腺皇皂泊线柏迫拍的怕伯魄
洋	羊祥鲜洪群搓差详氧汉羞
洲	酬州浅治渗渡蚤强搔划浪浦泳减栈灭浊裤钱
洪	港溢拱哄烘供共异暴洋恭基寒塞寨
流	梳琉硫疏帜织职澈海港漓识育凉滚注泣沾济淑
津	冲笔建律油肆肄沸沈渊健键洋沐汁水
洞	桐铜筒洽沮减硼同石壹喊碉拾恰哈泵言答
洗	铣先浩派况泊沃沉淫活泌法注淮沙汪
活	括恬阔话舌刮沽甜刮舔泊沃湖古千
洽	拾恰哈给蛤答汽合沦减俭洞澄捡检脸钥沧险石合签
派	脉泊沃洗活狐浩添潘澳湃
汹	胸匈泌泡池屯凶钝淘囤盹泥况沃
洛	烙格胳略络赂路客酪骆阁各
泵	石砂研砍拓硝硼司歌洽洞砰砸硫朱碌碰碘碉
炫	弦舷玄畜烁炕纤蓄吆以幻乐焙幼似亡几药
为	夷犬九癣姨胰吠你旭伏仇尤友丸突疚臭哭究莽伪袱鸠
炬	拒巨矩距局凹凸炸灶火炎渠烘烤炒炊灼协荔尖少
炭	岸岂崖不碳祟宗奈崇示票祭禁三御否平杯坏
炸	昨妒作乍户编少炒怎窄肩诈泪偏遍邀篇
炮	胞泡抱咆袍苞跑饱包雹刨灼
牲	性姓笙星产拜生物牡猩腥铲牛牧甥
狠	猖狼痕恨根退银猩很限狸狗狐狂眼犯
狡	咬校绞较饺交郊狈狭效
玷	斑琉璃王沾班珊玫站帖理玖瑰点占
珊	现王弄栅班斑玷玫理玖琐瑰再皿册杯盅
玻	坡波破披被彼跛疲皱皮菠琳玫板玖瑰颇班斑簸
玲	伶蛉冷铃龄零珍琴玫令吟班斑
珍	趁诊疹玲彬穆谚玫澎膨班斑拴栓玖瑰王
甚	勘斟堪农其辰甘浓脓振唇晨污棋期夸箕
畏	偎喂衰褥辱表长聘胃思农画甚辰田瓦牙互张
界	芥介囚串佛仲患胃思田袖伸川
疫	股投段殷般杀役壳毁殿谷设殴毅疼疯没
疤	爸笆芭邑巴肥把吧痕耙爬靶奢色春者
皆	揩楷阶谐混棍鹿比罢
皇	惶煌凰旺蝗白泉闰全皂王枉狂汪
盈	盘扁孟盔监杯盅益盛盗盟荡珊栅
盆	忿贫岔分芬扮吩份锰篇蓝篮粉氛仑盏尽盖瘟卢血纷初偏溢遍叨
杯	盔尽不盅否扁益孟盟监荡皿册珊栅尽
盅	皿册栅杯扁益孟盔盟监盛盗珊
省	眉算篡看冒眷渺盲劣督自目相媚楣
盹	趋目钝眠盯眼屯囤盼纯睹睡了睬瞄困想
相	湘厢箱目冒枕栅楣省眉看盲眷想算霜亲睬惧渺棚困督篡
眉	媚楣省冒算篡看盲眷自目相督首咱
看	眷牛省眉冒盲算目相牡督篡牲牧
盾	循目千自贯省相眉看冒肺沛算惯实箱
盼	寡目盹眠眼盯睹颁睡了睦睁眶贝分
砂	吵硝石炒沙抄妙钞砍研砰破朱砚碑歌码磷泵
研	砰硬硕石砂砍硝碰碘碌歌泵
砌	切批碍比昆庇屁能碳硼砂砚此碑北拐吩石
砍	歌吹欲证欧石炊玖坎次钦砂研破亩欣硝款欺碌确
祈	析近折听所斩斯芹匠新斧掀斤
科	料斜蝌秽禾秋和私抖魁稿秤租秘稍稚种斗香委番
秒	秋秽稍揪锹禾程稻秘和私秋香委番移秆稀称稿稼穆
秋	秒稍禾和私揪锹香委番科秤租秘稚秋杰
穿	芽呀蚜牙讶空邪雅窒窄鸦突帘究控腔
突	空究窄臭帘哭窒窗犬吠伏穿莽窘献
竿	旱干肝杆汗奸罕轩橄岸捍悍焊杆秆敢刊
籽	李季米好仔粥料粒粗子字糖糠怜孝存
红	丝缅纠细组肛江扛绣纪约虹纱纹纯纽纳绊绅
纪	丝纫纯细约纠纺纱纹纽纳绊组维绣绳绍绝缆
纫	丝绍绝纪约纱细纷纠纺纹纯纽纳纸绊组维绣
约	丝纯哟细纪纫纠纱纹纽纳纸绊组灼维绣绒
缸	肛江扛缺坛红虹罐工筑鸿汞攻功淘掏摇遥萄
美	姜羔义善羹对艾窑糕膳尖漾样仪牺
耐	而耍揣喘瑞端肘封射村尉付对辱
耍	而耐揣喘瑞端要需妻儒环还懦
胖	胜畔拌伴誊腾半绊拳倦圈判卷券眷
胚	肝肛不且歪同杯朋坏膘冠否示
胃	肤田月思有叠朋畏肩脊青骨育男异崩受卢明困棚回因
背	冀肯隐稳恶将胃青贵有尽萤虫止工朋肛啃
胡	古湖葫糊故蝴枯沽姑咕估苦居固辜胡捐硼个舌
胎	治抬始冶苔台台怠或胳域铭名
胞	炮泡抱咆袍苞跑饱包雹刨胸
致	致至玫到屋室枚救叙攻敢握窒矣
范	茫藻己已萍菠落蒲范荡扼薄忌圈脆桅倦
茅	橘矛雾务多侈芝舞爹予移茂序苏梦夕抒
苛	奇河坷呵何荷阿可寄倚崎椅畸葬啊
苦	葫居古枯沽姑固咕估胡湖做糊
茄	咖荔加另胁嘉男力肋若架勇艾劣协劫助勒勘幼勤
若	惹匿艾右诺茄荚哎荐吝吞君落荔送知佑
茂	苔减喊灭芝荐威咸莽岁成戚蔗蔑
茉	末沫抹莱叶枯枝杖苦苗芯茸草昔芋艾苇
苗	茵茴曲菌描锚万曹瞄田芯昔艾童尊遭槽
英	映秧央殃席满鸯瞒万萧巾蒂
茁	屈出拙倔掘微祟窟逆冈苗芯芭昔艾
苔	蔗台胎治抬始怠或莽茂冶菩名
苞	胞炮泡抱咆袍苟雹包跑饱刨芯
苟	苞芯拘钩芍狗句菊卜包够驹出葡叶蕊
虐	虚虎雪虏刁叼肤虑伺疟慧卢侵浸扫妇
虹	虫蚜蛆蚯肛江扛蝠虫红蚊蚪蚌蛀蛙蛔蠕蚓
衍	街衔术衙卫冲衡行御徘微彻征很徊律往征彼徙径徐得役
衫	杉彤彩形彭彪彰影修彬疹珍袄射
要	栗粟贾腰复栗迁价袖耍亚恶娄串由哑千
计	谊讯许订记讨访诀注咏评词诅诈诉详诚
订	评诬计讨讯记讶诀许注咏诅诈诉词详询
贞	侦贝员负页目盼则财狈贯货责败贴贵贼贿损圆贱遗赞
负	贪贝费员贞页目盼则财狈责贯货败贴贵贼贿陨损圆贱赞
赴	走起越赵趟超赶趣趁趋陡徒仆卦趾进坑壕
趴	跌足距跟跺趾跋跑跛践踏踩蹂蹈踪
军	轰库载荤晕连浑挥运阵范车辈轧辉莲轨轩软轴裤链
轨	轰轧软车轩轴较辅挽辆辐辑输
述	术术麻摩率穴么磨糜魔遮空弃充蘑
迫	柏泊拍怕伯白帕舶腺泉棉惶煌锦
郊	交效郑咬校郁狡部都郎邢邦那郭绞较
郎	榔廊朗郁邦那邢郑郊部郭都邪邮
郁	郑郊郎邦都那邢部郭邪邮鄙
重	动董肿种懂冲里千狸埋哩黑里范
限	很陌恨退根银阳狠阻阱陈眼艰痕阿阵陡陕防隅
陋	柄病隔陌丙阿除险限阻降院陪陆阴陶陷阳隆隘
陌	阿限阻陋隔陈阱百阵陡陕防队隅除院阳
降	隆峰陵锋蜂扳洛胳烙格逢略返版板
面	缅面毒母正市止逮步亦歪柿政衷肯症武拇怔姆票每
革	勒靶鞍鞋靴鞠秋缰鞭霸千巩萧坝
韭	歼纤三辰振唇晨御二行巧虫止工虹项兆示北
音	意章竟立暗竭昔童樟亿忆站泣拉垃位障境
页	烦顷顶顿颂硕频颗显项须贰预顽颁倾颇领寡颊头颓颖吨
风	枫疯飒讽飘台凰几刮朵凤虱肌冗
飞	灸久登疚发凳炊坎吹钦嵌葵升砍亩欣软玖欲次漱
食	养浪娘狼琅痒良餐仓伐苍疮沧抢呛枪
首	道自省眉咱算目媚楣篡导狈备
香	秆禾委番秋和私季秃历秀黍科秒租秘利稍稚
乘	秉利秃束禾秧俐莉痢梨忠秘犁秋速香和委番私
倍	培焙陪亿位赔菩竞接暗垃拉泣立
俯	府付传伐咐符俊傅侍栈伶践附腐令今械休条似念含
倦	圈伴胜扼腾券桅脆畔胖拌跪誊绊半己已范
俩	辆两便佩师偶佣伦偷布俭雨何伍价仁巾盒仑命
值	矗植殖置直俱宜什估仗仁真具使填慎镇信家且
借	惜措错昔倡暗醋并供莫萌僧摸漠亿模膜躏草音芭
倚	崎椅畸寄骑荷奇何啊可佑呵坷河苛
倒	到例室屋俐窒侧致至咧致握
们	门闪涧问闷闲间简倡但悯润阀
俺	掩淹庵奄布佑倚怖嫉僚价便伸仇健由希
倔	掘窟屈出拙茁倦呢伺伊已己侵祟届尼
俱	具值佣仁其直期棋植信且箕俏侦供姐欺沮伍
倡	唱晶但昌猖借替僧们暗伤赶踢
个	固估佃古做枯胡咕姑沽偎儡苦居舍
候	假仲侵夜健条又修刻暇剑虾没寝
倘	趟淌躺俏伙偿尚堂掌棠当伴赵膛当挡档裆铛肖常党
修	条候衫爪仲疹悠做傲收珍趁杉
伦	抡沦轮论偷俭仑侮伶伤喻愉榆逾儒
仓	苍疮呛抢沧枪舱食创伐养含今伏代
兼	歉嫌廉赚谦帘镰共金典并肃并曲羊臼齐册世只甘皿立六井升
冤	逸冕兔娩挽晚挽免勉臭竟嗅沉搀
冻	栋冰准陈次东冯冶冷凛匀凌凝于柬拣棵钧均炼迂吁
凌	陵菱傻后厦忧锋贩反赂板返扳各冬
准	唯堆推淮椎进雄冰次锥冷冻雅稚维谁虽离杂鸡
剖	部刮割创刚副删别刨划刑剂克则削刹剩刻刷刺到制判
剔	剃制剩利易刹削刺刮判删刨刑划刊剂
刚	删刨克则剖削刺制刷刑划副刹剩刮到别判利划列
剥	碌录绿氯刑刊副削刹刺剩到制利删判划列划剂
匪	啡排菲徘诽罪靡非悲辈靠
卿	唧节鲫柳铆聊即御迎抑孵仰慨溉概脚卵留昂
原	愿源隙白愿泉二柏迫怕拍泊伯凤笆皇习皂乒旨示三鸟
哨	硝当峭悄捎消俏梢销肖宵屑稍尚咪吵赵
唐	塘搪糖庸康允划州官佣慷台充中戈口哲班蚤强洲棺乡
唁	这信警誓譬誉言谅哼谆嚎嚷让计谜吭
哼	嚎嚷烹唁吭淳谆享吼图停谅啃唬掠凉啼唤晾搞醇
哥	砍歌石可司讯泵拓后桐破问哈恰拾
哲	誓折浙逝斤听芹掀析近匠斧斩祈所拆斯晰欣嘶撕
唆	峻俊梭竣酸骏唉凌吭赂锋贩吸反菱各
哺	捕浦脯补铺圃辅博傅搏膊甫缚蒲
哩	嘿埋里里狸理咽鲤童黑量墨
哭	器吠兽臭突咒单嚣犬伏莽严献奖状默区袱嗅狱
员	贺责货贯贵赞圆损贡费买贷赁赏狈陨资贾赘厕贝侧测溅
唉	埃挨矣唆嫉蜘矢厂族敏知吠做撤澈辙启故枚敬傲嫩撇
哮	教孝味酵轨咕吱染执诸夷子丈九享字
哪	娜挪那梆椰掷啊榔吗绑廊爷部邦鄙
唧	卿鲫节即迎抑脚仰昂御柳聊慨溉概铆
唇	辰晨振震三农甚韭如夸堪污巧浓脓
圃	哺捕浦脯补铺辅甫博傅搏膊蒲缚
埂	便梗硬更鞭坤坏坷坪由埋咽姻袖抽油
埋	理哩里里狸鲤嘿童黑墨量
埃	唉挨矣域嫉墩矢厂族敏傲撤澈蜘辙枚玫知做嫩撇
夏	厦峰胳贩板返扳处疼客格烙叛洛略逢版赂路
套	肆屋刁力握左云叼病虐奇男乓有灰另寿
娘	浪狼琅食养良痒餐始根退恨银宴奸痕
娜	哪挪那梆椰掷榔绑妈廊爷
娱	蜈误吴奴怒努如婿始氓好又奸絮
娩	挽晚冕挽逸冤免兔勉媚好奴奶媳竟境镜
孙	逊系孤县孔孩吼系悬细洁素累
宰	辜滓锌辟辞辛辨办瓣辫辩辣薛僻避
害	宪瞎割情清拓晴辖富合青猜债睛靖精蜻豁
家	家嫁稼定宇尺室士宣富宗完宾宜宋安穴寇寡十
宴	安案痕良根退恨银湿氨昌奸晶十娘按
宫	侣铝吕营官克圣古呜埠克舔苦居宋呈牢宅安写它召穴
宵	屑肖峭哨悄捎消俏梢销尚硝稍厂蔽撇赵膛当挡档裆铛
容	浴俗裕豁蓉溶榕熔穴谷却欲脚宾钠锥
射	谢村肘付尉封对寸寺守讨耐私待辱专尊
屑	宵肖峭哨悄捎消梢俏销屎尚硝稍厂蔽撇赵膛当挡档裆铛
展	碾屏匿尿尸屑屎居屈屡尼药接匹
峭	悄哨捎消梢俏销肖屑宵硝稍赵尚膛当挡档裆铛撇厂蔽
峡	挟侠陕荚夹颊凶崎来巫坐山疾卒匈
峻	唆梭俊竣酸骏峰凌赂锋贩反菱陵殿板返扳各冬
峰	锋蜂降逢格烙胳洛略板返扳夏
岛	鸟白笆鸣柏泉迫怕拍泊伯皂鸠鸵鸭鹃鹊鹏
差	羊搓羞洋祥翔靖鲜
席	满瞒庶度蒂戒希广英巾常怖布厉帮吊布庸砸啼棉饰
师	筛狮帅佩昙启两雨俩哑埠漏巾雪吊霍
库	载轰军连裤阵范车辈轧莲晕荤轩软轨挥浑轴运链
庭	挺蜓艇廷涎延怪奴只双又淫健逞程诞键
座	雁挫锉坐矣难瘫摊滩崔售焦集截府准推堆唯淮椎进雄催锥
弱	溺歹危殉死桅脆侯残侈列夕多殊殃殖乳冰
徒	陡往待徙很徊律征徐从街征彼循复行徘御微彻霉走
径	经轻茎行氢徐征得从后待役很衍衙衔
徐	除从复途御得待行径徒很徊律往
耻	耳耿取聂聪耽茸职揖聘联聊闻
恐	巩筑筑工恶汞肛扛江攻功贡忠悲氨宁丁耻红缸虹惰阿巧
恕	絮感如怠憾思忠芯忘志惹撼恭恩息怒患急怎闷惠惑忌忍
恭	共基益巷异烘拱洪哄供斯芯寒塞寨暴并港
恩	茵姻咽因怒思悠男老忠芯志惩更囱添
息	媳熄臭忌赞鼻虎想态兄沉怨唬嗅思怎忠芯志儿兑克免见凶先
悄	捎峭消哨梢俏销肖屑宵硝稍赵尚膛挡当档裆铛撇厂蔽
悟	捂晤梧语伍五恰伟违围苇
悍	捍杆焊秆赶旱旬干惕干慢岸袒坦但杆肝奸汗竿旦
悔	侮海晦梅诲每霉母拇姆毒恰愉敏憔佃繁
悦	脱锐税蜕说阅兑兄况祝铝嗅克息怕愧唬媳熄憎竞克虎
扇	翩翅翔翻翎翘羽习翁塌
拳	半眷卷券拌畔胖判伴叛扶圈倦捧绊胜腾
拿	合伟盒命苇围违韩登仑会俭纬仁答拾恰洽哈
捎	挡撇悄峭消哨梢俏销撑肖屑宵硝稍拌抄赵尚
挟	峡侠狭陕荚夹颊挫捧摊奉捉捷推拔扶扳找抓扣扒扑扑扎
振	晨辰震唇三拓扛打甚韭农堪巧捂捺污浓
捕	搏浦哺脯补铺圃辅博傅膊甫缚蒲
捂	悟晤梧语伍五抬拾伟招搭违捡拓围苇
捆	困困押果棵拇裸采描揉操手森抽抹林找佃扣扑
捏	捍提揭扬撮把时措倡持指唱坦挠晓搁拦手晶昌
捉	促足趴距跟践踏踩趾跋跑跌扣跺踱
挺	蜓庭艇廷涎健诞键延奴怪投淫逞程又只双
捐	损扣拐揖绢搞胡硼采抬撰操捉湖高亭葫台豪
挽	娩晚冕挽逸冤免兔勉扭扔搀竟把抒揉境镜挺批
挪	娜哪那掷梆椰榔绑廊爷邦邻廓
挫	锉雁坐推摊挟扶难摧拴滩夫瘫淮堆唯椎进锥拾拖催抚捡
挨	埃唉矣撤抬找撇撒嫉矢厂族掺扩敏澈蜘
捍	悍杆焊秆赶扬提旱捏撮干揭干岸舍袒坦但杆肝汗奸竿旦
捌	喇涮咧俐拐揖倒侧测例斗荆前莉痢
效	交郊疾校咬败狡放枚敌嫉政故教救启敏叙致赦
料	科粒斜粹米抖糙籽粗魁斗蚪斟糖糠糊
旁	肪傍榜膀磅房芳螃妨坊仿谤游防方纺淤访游龙
旅	施族于旋旗放方仿淤肪妨坊房芳簇
时	持恃侍特待等诗寺夺封对寸将博傅搏传膊晓砖褥遵
晋	参廊朗乡榔云郎厚三响溅织乓二晶幽卤良至虫一浅栈
晃	恍幌光辉耀显昌旦元星是冒岳旱晶完日愿
晒	烟西旦酒旺醋配酌酗酥酣丑曾量旱医
晌	向向昨眉媚楣晚明星奥映昭懊澳袄制自血日高
书	昼画坦在昌昔晶场堤曹春音香曾替间旨日倡唱袒
朗	郎盏育晋参朋浅栈钱乡榔廊明馁溅幽卤
校	咬狡绞较饺交效郊朴柱父六
核	咳孩该骇刻亥朴柱校柿杭拥亡
案	安按寨宋宴氨奸森十鞍茶菜审药辱妻妥宇守字穴寝
框	眶筐枉栓班斑王枢柜拴琳痊旺汪惶煌润逛凰
根	退恨银痕狠眼限很跟艰查腿褪堰良
桂	挂畦娃佳杜卦蛙鞋挂褂闺封涯崖
梳	流琉硫疏帜织职朴梅识育杭柱
栗	要粟贾栗复腰迁价袖裸亚困恶串由哑千
桌	卓退采闲床宋呆森掉悼林晰栽柴柔某梁柒集朵乐木淋沐困
桑	缀又友建延廷疫壳没奴只双庭夜殷浸挺般候段杀假
栽	专惠床截团传梁裁载乐砖戴转宋铁厢穗团
柴	紫些嘴柒上也迂桌某采床宋呆森卡林琳快此池弛
桐	洞铜筒棚硼同石壹喊碉洽拾恰哈答言矾
格	烙胳洛略板络赂路客酪骆阁各
桃	逃挑姚跳兆北排啡遣溃遗
株	珠朱殊蛛朱柏材槐未千宋林析板才
桅	脆跪诡危扼倦侯配已己圈范
栓	拴痊榆检全枉框班斑王梅玲珍惶煌枪润椎琳筐
殊	蛛株珠朱死歹殉殃殖残列朱
殉	歹死殊殃残列殖歼询咧例尸笋
殷	般段壳股毁殿投役谷殴杀设毅疫没所浸侵搬淀锻乍户房
气	氮氧氨氯氛粥屎氢粟粱迷咪糜米汽
氧	气氨氮氯氛氢洋鲜
氨	氮氛气氧氢氯按汽安何鞍
泰	春奉秦奏捧凑棒蠢揍榛桩尿泉泵水挟援
浪	娘狼琅食养良痒餐浦泳浅治湿根退恨银渡沧痕
涕	梯弟剃第降沿涉洪津郊泌泊油沙冲沃
消	捎悄峭哨淌梢俏销肖屑宵硝稍沙赵尚淡膛挡当档裆铛撇厂蔽
浦	捕哺脯补铺圃蒲辅博傅搏膊甫沛缚
浸	侵没寝殷股殿投伺叼般液洛段扫妇设壳毁役漏毅殴谷候涎假
海	侮悔梅晦诲每霉母拇姆沧毒沦洽汽
浙	逝渐撕折晰惭嘶掀斤崭析近听芹匠薪
涉	步止扯址遣肯企泣注沾歧源江济啃汤沥逃正武岁
浮	俘脖荸深净游淫滔沉子浑溪渤厚享学
浴	俗裕容豁沿溶谷熔榕欲却蓉脚洽铅钠锥
浩	造酷窖告淫呈洛洗任沼廷逞涡沿治望圣吉
烘	洪拱哄供共异港恭基寒塞寨暴溢
烤	拷铐考丈炬炸杖绪仗熔勒灶协燃者老平火煮炎宏孝尖
烙	格胳洛略络骆赂路客酪阁终各
烈	裂氮煎陷斗丁邮隙鱼炎灸荆钉咧例阿邢列打
乌	坞呜薛叔鸟吕足迷淑启帅寂埠椒召谜
爹	多移侈令铭梦麦宛舞夕名父丸够外
特	持时恃侍待牡等诗寺夺封对牛搏传褥遵牺牲符
狼	浪娘琅食养狠良痒狭狈狸狡狗狐狂犯猖餐
狭	挟峡侠陕荚夹狡狼狈狸狠狗狐狂犯
狈	员赞责贯货贺贵赁侧测溅贝贡厕费买贷赘
狸	埋哩狂里狠理犹狗犯独里
班	斑琅球琳理瑰王逛玷珊玫玩玖琉栓
琉	梳流硫疏璃斑玷班王
珠	株朱殊蛛瑰朱球班斑王
畔	圈胖拌伴半绊拳倦胜誊腾判眷卷券
亩	炊钦坎吹砍软玖次歌久疚欲欺款欣饮歇歉欧
畜	玄蓄炫弦药吆关舷似烁么乐拗叽以机幻砾
留	贸瘤溜榴馏柳铆聊刘卿屡乍户卵孵印
疾	矣效嫉矢枚启故知玫牧敞敢散敬改收敌数
病	柄丙陋左内奇症有奈瘟钠呐疾套疚肴灰布
症	整怔歪征正政止肯武企左扯址遣步逃啃歧
疲	被波披坡破玻彼跛皮皱菠板颇簸疼格
疼	冬终冬返客逢板扳阁烙胳格略洛叛
疹	珍趁诊彬澎穆膨谚痊疙疮衫须杉须修彩彤形
益	溢隘共恭盅基杯盔扁巷孟盟监皿册栅
真	颠慎填镇宜直且值植肺沮姐沛谊衅
眠	氓民眼盹目盼盯睹鼎睡了睛睦睬睁瞄瞎
眨	贬泛乏之瞪芝睬瞄瞧盯睡目
矩	矢炬知拒距巨枚短协矮疾荔矣故启玫牧敞敢散
砰	评坪秤研平硬硕碳朱砂硝碑石萍
砸	碾碉码石硝碘确啼硼泵常命
破	玻被波跛披坡彼疲皱皮菠砍砂板歌颇簸
祠	饲词祖祝祈社福神祥祸司
祟	宗奈票祭禁御示岸出三碳炭崇二不灭些茁屈否斋捺棕杯拙坏
祖	组视祸粗社沮姐祠租祥祈蛆阻且宜
神	绅坤呻伸申缕祈社祠祖祝祥福
祝	况兄祠祈社视祖神祥福祸
秤	坪砰评平秋租科稍和私秆禾萍秧秩秘杯稚种秒穗秽香番委
秧	映英殃利央秃租秋稍和私禾秤秩秘科稚稀称稻俐稠
租	粗称稻稳稠禾秋稍沮姐和私秤秧秘祖科阻稚且香番
秦	榛奏痢矮泰春奉禾凑揪揍桩播萎审潘锹
秩	跌失种秘秋和私稚禾秧租秤科稍税秒程稻穆秽香番委黍
秘	禾秋泌和私租秩科稍税稚种秒必香番委
窄	窗窖空穷窃穿突帘究窍窜乍户炸昨妒作
站	立沾玷帖占音店贴点章童意泣拉垃位倍培焙靖竭储
笆	疤芭邑巴肥把吧爸耙爬捣皂白绝靶貌藐色
笑	夭沃妖奏吞添舔笙侨娇桥矫契乔卑勿凑揍轿骄
粉	扮吩份纷芬氛分忿岔米盆拐精糕糟贫寡粪
纺	丝纹绞妨绰纱统细纪肪坊仿纤织缝纯纽纳纸绊组纫约
纱	丝绊细纺纹纯纽纳纸组纪约纫纠炒维练绣
纹	丝绞纺统细绰纱纯纽纳纪绊组约纠维绪绣缔纤
紊	丝累系素索紫絮繁系紧纹哟细辫吝罗蕴文纱纯纽纳绊
素	丝累系索紊紫絮哟紧繁系细毒青罗蕴纱纹纯纽纳绊组
索	嗦丝累系紊素絮紫系哟紧繁细辫罗蕴纱纹纯纽纳绊
纯	约丝纪细纱纹纽纳纸绊组纠维绣绳
纽	丝级细维纱纹纯纳绊组纪约纠绣结
级	圾吸纽丝纱纹细终络纺纯纳纸组绊纪纫约
纳	丝维组细纯纽纹纱绊纪约纠绣给绢绘
纸	丝纱纯只细约纠线纺纹纽纳绊组纪纫维绣
纷	绍绝粉扮吩份丝纫结绒绢线纱细纪芬
缺	缸罐坛决快淘掏摇遥萄陶诀
羔	羹美姜窑糕焦黑义善对蕉炎墨膳
翅	翔翎翩翘翻扇羽塌翰翁习
翁	嗡塌翰蹋习翠翼折
耘	云云仁耕耙耗禁寿三二魂
耕	拼构并耙阱并井屏借籍耗饼
耙	把肥吧耕耗巴笆疤芭邑爬靶爸耘
耗	撬尾毡毛耙毯耕耘
耽	枕沈忱聂耿耻取耳聘聪职联聊椰茸
耿	耳耻取聂耽茸聪职揖聘联聊闻摄镊椰宵居
脂	指能旨比昆批庇屁化匕觅尼它
胰	姨仇夷九轨肋旭究友丸朋央疚然奥肚鸠肌为月染筋
胁	荔力肋男努另协加勇势劣茄勒咖劫助幼功
脆	桅跪诡危扼倦侯配己已范圈
胸	汹匈胞屯凶爱盹钝朋囤胰肥肚肋月
胳	烙格略洛络赂路客酪骆阁各
脉	派脾肌貌舀冗狐朋肿腺鹏藐射胀肪肚胳旅衫淫彩股滔沉杉彤
能	庇比批昆屁脂罢熊态指呢摆皂
脊	铜钢胃有朋期益骨肩青育崩受商肖月棚明滴摘嫡
胯	垮夸跨愕夸脓捺污巧朽奈
臭	嗅息哭突犬吠伏赞莽献奖鼻器状兔默兽
舀	滔臼稻蹈冗肌窜身焰艘舅鼠阎旧脉陷脾腺桩
航	舷舵船舶舟艘舱舰炕杭抗坑吭艇
般	殷段股壳毁殿投役谷设杀毅殴疫搬没盘
茫	芒范藻荒亡菠萍落蒲荡薄忘妄
荒	芒慌蓄茫亡忙谎盲忘妄菩荠蒂蒿芦芳氓网
荔	茄协胁男另力肋勇艾劣勒勘咖勤助劫幼
荆	莉前刑型华痢厕罚开斗捌倒研咧俐喇例哗桦
茸	聂耳闻耿耻取耸声聋椰摄镊爷丛揖饵趣
荐	存艾若荆莉前荸荚梨煎幕斗子茵茉芋李孝字萧茄痢荔
草	章昔早樟芭障萌莫卓借措惜错
茵	苗姻咽茴恩曲因万艾描锚曹男菌若芯昔薯更囱瞄
茴	苗回茵禀曲徊蛔回万描锚曹菌若苦苟芯昔艾瞄墙
茶	休苍菜花叶蕉芜药荷付
蚊	虫蚪蛀虫蚌蛆蚯蛙蛔蟀虹蛛蛾蝇蚣螃蟆蚓蜘
蚪	虫蚊蛀蝌蚌虫蛆蚯蛙蛔蛛蟀
蚓	虫蜓虫蛹蜘蝴虾蚪蚌蚊蛀蛆蚯虹蛙蛔蚣
蚤	虫搔闽蚀骚蛋强虫蟹融梁蛮蚌蚣蚓蚊蚪蛀蛆蚯
蚌	虫蚪蜂虫蚊蛀蛆蚯蛙蛔蛛蛾蜻虹蛹蚂蝇蚣蛇蚓蝴
蚣	虫虫蜕蛇蛉蛤蜻蝶蝠蜗螟蟆螺蟀蚪蚌蚊蛀蛆蚯蛙
蚜	虫呀芽讶穿虹蛆蚯蝠虫蚊蚪蚌蛀蛙蛔蛛蛾蜕
衰	裹畏偎喂还回禀威衷畜娄言奸表长卜
衷	褒袁只旅迎哀衣逮远昂氏依抑遣仰衰畜娄亮裹裳袋裁昏
袁	园远吉猿衷喜台褒嘉哀辕裳旅售告周
只	纸婚抵低底氏昏衷
记	诡词讨讯计访诀许订注诅诈诚详询课谁认
讨	诀诗谢讯记计订许注咏诅诈详诚询课谁
讯	计记讨订诀许注咏评诅诈详话询诵课谁
训	诽计讹谜谢谴讨讯记许诀订注诅诈详询课
岂	痘丰登逗短竖炭崖岸豆凯凳壹合
豺	豹猫财材闭射才垦恳解黎秩衫彩杉彤刀历
豹	豺猫的钓灼酌约芍恳垦解忽射哟刀屉忿
财	贝贩败贴贿账赌赚贼贱则贮贬赂赔赐赠
贡	贵责项员汞工溃遗贯货费买贾质赞
起	赴走越赵趟超赶趋趣趁陡选撰巷
躬	身躺躲穷躯儿臼凿焰几陷舀阎肌滔馅反凡朵冗
轩	轰轧辆车软轨轴辅辐较轻辑
辱	褥寺守专尊寸肘村付牙讨射耐尉封对
送	逆掷立艾遂郑泣拉垃道位哎遭辛音若羹
逆	冈送溯立道遂钢岗泣拉垃位遭辛音茁
迷	咪米屎粥谜粱气料粗粒籽怜磷乎粟糜
退	根恨银腿褪痕限眼狠跟很艰堰良遏卓桌宴
回	禀茴徊蛔回凛遇衰裹还墙卜
逃	桃挑姚跳兆遣遗北止排啡诽扯址溃步正肯
追	锤迫返近造回启帅透逢埠炕杭遍抗坑吭
酒	医酱配酌酗酣酥丑酷醋酪酵醇醉醒酝酿酬
配	酌酗酣酥丑醋酷酪酵酸醇醉醒酝酿酬
酌	配酗酣酥丑醋酷酬酪酵酸醇醉醒酝酿
钉	打叮丁盯订汽可歹钙贮空针顶钮河钦坷呵钳
针	锭铁金铐镇十汁什钉钓钮钠钝钞钦钾钳钩银
闪	阀合门问闲间闷欠闭闰开闸闺闻们
院	寇完阵除陶际隐陌阻玩陪陆阴陷降陋阶阳隆
阵	轰连库军载车范轧裤辈轩陈软轨轴院浑挥运链荤
陡	徒走赴陆陕起越防赵阵陈限陌阿阻阱趟除陪陵超赶
陕	挟峡侠狭荚夹陡阵陈限陌阻阿防阱除险附
除	徐途险附阴院陪陆陶陷陋阳隔际陡陕陈陌阿
只	双售集焦又奴健怪获获崔庭夜挺候涎淮推堆唯进
饥	饭饿饮饵饼饱饲饺蚀肴馁馅饰馏饥
马	驮驰驳驻驶驹驯驼骇骆骑骗驱骡验
骨	滑朋猾乱崩受棚辞爱涡过硼肮锅髓
高	膏乔亭豪毫蒿篙搞镐京稿亮享敲
斗	前闹划事赤亦荆捌莉俐痢沸拂喇佛
鬼	傀愧块魁槐么刃几瑰魄匆魂叽机魏
干	干朝斩翰韩麦麸嘲潮庙惭渐崭你仔面您乞
伪	伏伐袱代犬佣灰今跋吠伙俊伶仓筏食念含令
停	亭信搞嚎壕镐仆偷稿高蒿豪篙
假	暇虾霞候侵健促夜浸般股投没又疫
做	故估傲橄启敬湖嫩撇撒糊邀枯咕姑沽族唉个苦
伟	违纬韩围苇拿韧笨俭本晤梧悟捂信伺讳休伍卫合
健	键建夜假候挺肄奴侵只双涎蜓怪又庭
偶	遇寓隅愚迈藕佃万俩佣伸侮布厉甲巾每
偎	喂畏佃儡个衰侮僵辱聘褥表长画每
侦	贞债侧贝仆傍贪货员败狈贴财盼贿位住损贼价贱遗偿
侧	测厕则货员资俐溅狈责贯费贵贷赁赞倒例债贝贡买贺贤赘
偷	喻愉榆逾输伦愈俭伶侮伤
偏	遍编蝙篇扁作盛匾仑肩温滥篮
兜	征乡微昂迎抑秃仰惩儿症衣允氏风笛笔衷袁亮媳嫂很徊律
冕	晚娩挽冤逸挽免兔勉间简涧竟星昌晶昆昨境镜
凰	惶煌蝗皇风斑班旺凤筐几框痊逛栓拴柏腺
剪	煎芬箭前寡氛拐吩扮份刀粉纷砌初
副	剖割划到刮刨剑刽别刑列划刊创剩刚剥刹削克则刷
勒	革靶鞋鞠鞍协靴秋缰鞭胁勤肋功千
务	矛雾茅橘胁矣胜踊救教启敏赦敦敢散敞敬故
勘	甚斟堪助功幼胁勒劲勤劫肋荔茄动勋勉勃励
动	重肿种懂董劫胁勒助肋幼劝协冲男劣
匙	题化比昆此北能批是屁庇死花皂
匿	若惹诺右艾展哎屏君荔茄落区尸荚智送群裙知吝
区	呕品岖枢器噪欧嚣躯驱殴操临板鸥
匾	骗扁偏遍篇盛翩肩编蝙匠册乍皿户盆篮血刀屉怎昨栅炸盅
参	廊惨掺渗晋残盏朗乡榔咸浅栈郎钱
曼	漫曙蔓慢幔卖闸甲钾押匣薯泽浊馒
商	嘀嫡摘滴适六高交向脊过尚滚铜锅
啦	拉接撞立垃泣位扑培倍焙菩音
啄	琢吁叮哑呵呀君
哑	亚恶嗤听吁叮片啄师呵呀啃喘啡喇串栗要
啡	排诽徘匪菲罪靡非靠悲遣辈
啃	肯址扯企趾武止歧历遣岁啼遗步正喻唁靖赋嚎沥涉怔
啊	阿呵崎倚椅畸寄荷可部坷河鄙何骑苛奇
唱	倡晶昌猖喝嗜吧邑暗智惜措袒借捏坦但涧踏
问	板门闷闲间闪阐闭闰开闸闻闺闽阅阀阁合们
唯	雕堆推淮椎进谁锥礁崔准雄稚离杂售
啤	碑脾牌卑吻叭千唾咱呼听呈
售	焦集吉只双唯崔告堆推淮椎进锥雇截周奋蕉雀坐准雄
唬	号虎嗅彪递沉滤据炉疟
圈	倦卷畔券胜胖拌伴扼腾半已己绊桅脆范范
国	域或惑台胎苔始抬治圃怠路冶
域	国埃或惑胎始抬治台冶塘去苔路城怠
坚	肾紧贤竖宦臣服卧怪藏报候临型压鉴捌赃脏
堆	唯推淮椎进锥崔准雄稚雕离杂
埠	坞薛筛启垢块帅狮师吕宫域培坑坟追侣味咕吱铝乌
基	共恭塞益巷异烘哄拱洪供斯寒寨暴并港
堂	膛尚掌棠当常党肖尝裳赏当挡档裆铛淌倘敞削
堵	睹诸奢屠暑着绪赌署猪者煮都曙储薯
执	丸垫挚堵轨爹势孝热哮夷夕九痛教胰姨疑旭外仇侈
培	倍焙陪垃境赔菩竞接暗拉泣位立
够	多钩拘狗移侈爹驹苟出令铃伶矛予
奢	屠暑着署堵睹诸者绪赌煮猪都薯储曙
娶	最撮取耳支丛妓趣茸安耻耿枝肢吱技
娄	由屡篓搂楼申袖坤呻伸笛宙神抽油缕
婉	惋腕碗豌宛嫁婶妹姑妓死夕始侈姥外麦尸字
妇	扫归帚伺带浸侵叼虐刁雪帝慧啼而耍蒂
婚	昏抵低只纸底氏媳
婆	波菠皮板疲反被格破玻坡披各冬跛洛彼返扳
寇	冠完院玩元宗顽定崇宣棕寂家室宇富宾敲
寄	崎倚椅畸奇骑荷可啊苛坷呵河何
寂	淑椒叔督宠宰寇鸟乌十迷滓宵定宋写安穴寒宗水坞呜
宿	百干缩宣丘陌轮输荷全痊答会察合偷途喧伦栓
密	蜜必泌秘瑟虎宁岔唬递宽宛勿彪宾完审息忽易克匆兄
尉	蔚慰村肘付射封对寸寺守讨耐专尊辱屎
专	团传栽砖守转惠寺尊辱截寸村肘付裁载尉射封对团
将	蒋状妆壮膊墙肘博傅搏缚褥时恃持侍庄
屠	奢暑着署堵睹诸者绪猪赌煮都薯曙储
屉	履薇症复纵踪律很徊往从徒徐待征德行
崇	棕综察蒜捺宗漂赊标膘襟际
崎	椅倚畸寄骑奇荷啊可坷呵河何苛
崖	涯炭岂岸洼畦桂娃挂卦佳闺王挂蛙封褂
崩	朋棚受硼骨岗爱瞬授溯滑乱睬绷蹦鹏
崔	催摧瞧堆唯推淮椎进锥雏雇惧售焦集奋蕉准雄稚
岗	钢冈纲崩刚逆溯册皿睬塑盅茁血山栅睁
巢	灾剿巡腊猎恼棵脑裸蜡奸裹果
常	掌棠当赏党尚尝裳堂吊蒂肖啼帅当席希砸削膛挡瞒档裆铛
带	帚妇扫滞帝蒂啼归布慕巾吊常希老怖布缔瞒蹄
帐	胀张账长涨巾帖帕帆幅帽幌帜
康	慷糠逮庸唐允划州曼搪塘佣充戈水中强班蚤乡搜嫂洲肆慢漫
庸	佣巾席吊布康唐市央允殃盅划帝帅帖帕帘怖满希布州
庶	度戒席广蔗遮芜械无廉抚煎痰盏蒸燕蕉戈渡镀
庵	掩淹俺奄希由鹿笛宙布尤犬袖怖
张	胀帐涨账长刁叼畏引偎喂伺表弓辱急虐司
强	虫搔骚蚤虫蜜萤蚣蚀蚓闽蛀蛆蚯蚊蚪蚌蛔蛙蛋虱
彬	杉疹澎膨珍穆森林材趁淋彩诊谚琳须衫
彩	杉衫彤形彭彪彰影彬疹珍穆射膨趁脾脉豺须物修
得	徐待很行从径复后德役徙徊律往征彼御衍衔
徙	往徒律征很徊徘彻循彼得从徐行御微衍衔
从	徐复纵踪御待行徒律徊很往得径后德役徙微彻征
徘	排啡罪诽匪菲靡非律徙征御街微衍彻衔征徒往徐行
御	徐卸从微衍衔律复徘术街彻征衡霉徙徒很徊征往得
患	串忠介恶听宪袖德川思界芥芯志厅亚事而片训驯拂沸
悉	乎呼蟋释窃米慰愁屎迷咪您息思怎想粱粤忠忽愿芯志悬粒
悠	收恩条修嫩怒矢涤患疾忠矣惩叙做傲
您	你愁愿凭悬悉闷怒思急忠芯志惫应乞干灼仔鲜
惋	婉腕碗豌宛愤怜死夕侈憾慎外麦怨尸字多
悴	碎粹醉翠卒伞怀摔掖液腋忆悼忙午
惦	店勾勺占惨憾图沾站玷帖廓匀
情	清晴猜睛靖精蜻请青债积绩责
惜	措借错昔慌暗醋懂世莫萌摸漠憎模膜忆草音芭旬
悼	掉绰卓罩忙早悴忆章桌草退恨恬昧怕悍障樟
惕	锡赐踢易勿忽吻物悍慢旬剔匆
戚	威咸灭茂减喊不上延否示岁御成涎杯坏
掠	凉晾鲸景谅搞攘扑抗京掖摔擅拥接就拄拉抖挤占
控	腔挖空窒麻穿拭拯按搓抵技丰窄突帘究穴
掖	液腋夜摔抗掠搞擅拥攘扑投迄提健挺
探	深采挣授挥援摇捐控净揉换浮持搏损睬俘拖扮播擂静
接	撞拉啦霎培焙倍暗泣垃位立陪境障樟幢亿赔
捷	抓技按丰拷控摊妻掉推挟捕捉挫括搪拂抹抽押找扯扑扶折抖
捧	棒揍奉凑榛桩扶泰春掩捺降撩撵挟拳秦奏
掘	倔窟屈拙出握揽扼茁卷倦招呢撬拒已己圈
措	摸惜描借错昔搭暗醋拱拼莫萌指搓漠模膜草音芭
掩	淹俺庵奄捺抽捧揍怖撩布搂抛由希
掉	悼绰卓罩抖扑拉拄挤早摘扯掠接摔抗擅章桌草
扫	妇归帚伺带揣握浸侵叼虐慧擂刁雪帝掘抡啼招而蒂
挂	褂挂卦畦桂娃佳挠闺街蛙鞋封涯崖
推	淮堆唯椎进锥摧崔挫准雄稚离杂
抡	伦沦轮论拴拾舍捡仑偷擒捻愉喻抢榆逾拖
授	受采探挣援朋挥摇棚崩爱静硼骨
挣	净狰睁静筝采争探授挥援摇捐掘深揉揖换浮持搏睬
采	探挣授睬菜采挥援摇踩荣揉操肘捐搏膝捆
排	啡徘诽匪菲罪靡非挑悲辈靠
掏	淘陶摇萄遥谣缺缸坛摔罐
掀	折欣析近听芹匠逝浙撕斩斯祈所斧
捻	抢念吟拖伶抡舍拾拴铃捡擒黔今
舍	舍拾拴捡抡抢干捻拖擒捍搭俭偷伦恰洽哈检脸钥舒估
捺	蒜棕漂标膘襟崇综赊际察奈
救	求球敢故致枚矣教败启敏叙敞散效敬放牧玫敌敷数
教	敦枚哮叙孝敢故启救敞散效敬牧玫改敌数收墩疾
败	贿贝贩财贴赌赊账赚贼贱则贮贬赂赔赠
启	故敬枚牧敞敦敢散帅放玫改敌数收敛做矢疾矣
敏	矣繁敌每救叙启敞敢散效故敬致放枚牧玫数改收挨
叙	斜枚教敦敢致玫攻敛救败敏启敞散效政故敬放牧敌数
斜	叙料科蚪抖斟魁途蝌斗伍除涂徐丘于
斩	惭渐崭析近折听斯祈所芹匠新斧掀斤暂
族	旋旅施于放旗簇邀方激仿淤缴窍
旋	族于旅施旗漩放方础淤仿簇
昼	书画坦查袒旦堤但量三旱在杆焊捍悍汤阳旺
晚	冕挽娩挽逸冤免兔勉间涧简昨竟晌境镜晶昆
晤	梧捂悟语伍五伟昭违围苇旦
晨	振震辰唇旦三农旱甚韭是夸晤堪旺污
晦	侮梅悔海诲每霉母拇姆毒敏佃繁暗帜伶职偶育
曹	曲槽遭糟尊曾农苗昔茵茴昌描遵锚
望	呈牵淫圣造任盲窖浩廷告逞酷
梁	粱床栽蚤乐厢浅治沐柒采桨宋呆森药淋搔林烁
梯	涕弟剃第梆榔椰降松椭
梢	稍档消捎悄峭哨俏销肖屑宵硝杰赵尚膛挡当裆铛撇棠厂蔽
杆	秆焊捍悍赶杨查旱杆干棍渣喳干粮橄岸袒坦但肝汗奸竿旦
桶	通痛蛹诵橘移橡怜用夕李
梧	晤捂悟语伍五伟格极违检围苇
梗	埂便硬更鞭杯枉析杆楼柄朽橄由
械	栈戒橱梭诫村私寸庶度渡遮镀蔗俯松扩旷肘付
弃	遮戒充率述茉育玄庶度母卜械
梭	峻唆俊竣酸骏格栈板械凌杭锋贩反菱
梆	绑椰邦榔挪娜哪掷爷椭蚌丰廊
梅	侮晦海悔诲每霉母拇姆枪毒栓榆检梳敏
条	涤修仲候爪休附付俯悠介
梨	犁莉痢俐利秉秃朵闲柔存乘秧漱嗽荐染季李森斗束禾喇
欲	却吹砍歌钦欧歉炊坎溶榕熔蓉软欺亩饮歇欣玖次脚疚
杀	殿段股投殷壳般毁役谷疫设毅殴没淀臀
毫	高亭豪膏牵亮享京烹毛逞尾嚎台蒿篙哀停毯耗搞
氢	茎径经轻氨氮氛氯气氧劲
涎	诞延挺庭艇蜓廷没健键奴浸怪只双又
凉	掠晾鲸景谅淳沾漓京液淑流滚就泣注济占
淳	谆醇凉享液沾哼漓浮郭敦墩廓
液	掖腋夜淳凉漓浸没迄洛健悴流滚泼滤泣注波
淡	炎痰毯谈氮渔消炒沙燃荧蒸淌恢糕伙水火杰灰
淌	倘趟躺消尚堂棠掌当沙膛挡当档裆铛肖常党
淤	游漩于肪妨坊仿房芳簇防旁纺放族旋旅施方游
添	沃舔凑妖夭笑侨娇桥奏澳矫轿吞泪浩洛滞潘骄泊
浅	栈渗钱治渡残贱践洲盏滋掺惨
清	情晴猜睛靖精蜻请青债积绩责
淋	森林沐琳湘彬渣漆栋沫决村材漱焚
涯	崖汪洼污浇畦桂挂娃卦佳润蛙封汗污挂褂王
淑	椒寂叔注泣沾济凉督淤游澈鸿滴流漓
涮	刷测前捌喇侧倒咧俐例沸
淹	掩俺庵奄油滞怖潦布汰由希
混	棍鹿罢昆皆揩楷比汤阶
渊	冲津沸油肃沈啸锈萧箫凄汉沐江汁济溃水
凄	栖汁妻沽沛演冲湖渐潮渊浪浦津活派沫沸
涵	函汛乙泳涣渔没乞汹河沸况泡沈沐冲
泪	沪嗅偏遍炸昨妒作邀溪编蝙袱乍犬户
淫	滔沉浩深净逞浮望浑程溪滑任挺洞庭告呈
淘	掏陶萄摇遥谣缺缸坛罐
沦	伦抡轮论洽汽仑偷海愉喻沧温榆逾
深	探净浮淫滔沉浑溪滑洞涡沮清测溅
淮	推堆唯椎进锥汇崔准雄稚离杂
净	挣狰睁静筝争深浮淫滔沉浑溪滑洞涡沮
淆	肴肴汰有学滞淌消浦汹郁沮滴沈沛
烹	享京哼亭高亮膏豪毫淳逞吼了郭景哀熟廓图占凉掠停晾
焊	杆捍悍秆赶旱干干爆岸袒坦但杆肝汗奸竿旦
爽	肴囱淆拔樊希攀大稀窗跋募驳努学疗
牵	毫望牛盲牢牲牡件畜看亥玄特湃拜牧物
犁	梨利牢莉痢俐秉湃件秃牛牲看乘秧秩牧漱嗽牡
猜	清情晴睛靖精蜻猩猾请青狰债积
猛	锰孟栅猖狰猜偏猾遍季孝存
猖	猩唱倡狠晶昌猛狰猜猿猾狞狼狸狗
狰	筝净挣睁静猾争猜狈猛猖狞犯
率	摔卒蟀什午述弃充敏遥遮畜豪矣育应瓜母卜悴逢碎
琅	浪娘狼食班养球良瑰斑王理珠珊玷玩玫玖琉
球	班琅求救珠瑰斑王理玷珊玫玩玖琉玉弄
理	埋班斑王哩里环狸玷珊玫瑰玖里弄
现	规砚视观觅见觉珊瑰搅班斑窥
瓶	瓦瓷并井耕拼并阱互屏饼沟构夕
瓷	姿咨资瓶瓦次多嵌登爹葵凳互夕久丁移
甜	舌刮舔活括恬柑钳谋阔酣话媒煤甘虚嵌
产	笙铲星牲性姓生萨猩腥甥隆频猜拜醒
略	烙格胳洛络赂路酪客骆阁各
畦	桂挂娃佳蛙卦鞋挂褂闺里封涯崖
毕	幸辛苦南华着宰葫锌
异	粪戴共烘洪拱哄供冀基恭寒塞寨暴港溢
疏	蔬硫琉梳流帜职识织止遣扯址逃肯育企
痕	根退狠恨银疤眼限很跟艰奢良堰腿褪
痊	栓拴全斑班疙王疹疮筐逛框
盔	杯盅益盈盟扁监孟尽皿册栅盛盗荡珊
盒	合拿命仑登钥会俭仁答凳伦洽拾恰哈
盛	扁成篇偏遍蝙城编盅监匾盔益盗盟盈杯肩孟荡栅
眷	看半拳省冒卷督眉盲券目相算判篡畔渺胖叛拌伴
众	聚买罩置骂罗罪罚纵还踪梦从环
眼	目根退恨银眠盹睹狠限盯了痕盼跟很睡艰睬
眶	框筐班斑目困盼盯睛睦睁瞧鼎眼眠盹睹睡
硫	琉梳流疏识碎碳碗磅砾石磁碟碾磕帜砖礁职矿
朱	珠株蛛殊碑朱砰砂石破硝砚碰碘
祥	鲜洋社祖礼羊癣祠神祝视祈群详
票	宗奈祭祟禁御漂膘标示三碳瓢飘
祭	宗奈票祟禁御察际示擦仁三碳二不灭赊
移	侈爹多令铭麦宛季夕舞梦秀秒橘穗够私外利禾
窒	室屋空至倒穿突控腔握致到致
笨	本策围苇禾伟违五秤纬韩番柔香委箱秉租秋杯枉和私杆
笛	宙篓由袖油抽笔箫轴爪娄申聘徊
第	弟梯涕几降剃邪引
符	府咐附筏付等侍八寸傅传冠蔚厨夺特时俯持恃待
笙	产星牲性姓生铲猩腥甥隆笑萨牛猜拜醒
粒	料樟米泣拉垃位粹糙粗籽焙立糖糠接培倍暗糕糟
粗	租米祖沮姐粒组料籽阻且宜
绊	丝纱细组纹纯纽纳约纪纠维练绣
统	丝织纹纺绞绰细纯约纪纠绣缔纤绊绅组纱纽纳
绍	绝纷结纫络绢昭沼招丝纪绒给超线缆细纱
细	丝绊绅组纱纹纯纽纳纪约纠维练绣
绅	神缕丝细绣纠坤呻伸绊组纱纹纯纽纳红纪约维练
组	丝祖缓细纳绊纱纹纯纽红纪约纠维绣绢
累	丝系紊絮素索紫细哟繁系罗螺骡
终	络疼烙线丝逢绵编骆总纤级纸返缝冬
羞	扭羊差丑钮纽洋祥翔搓鲜
翎	翅翔翩翘翻扇羽领嗡翁塌翰习
习	折翠翼翁塌寥嗡胶翰蹋
聊	铆柳卿留聂刘溜榴聪贸瘤御唧迎抑仰耿耻取耳
脯	膊浦捕哺补铺圃辅博傅搏甫肺缚蒲
脖	荸肺浮俘勃沛渤嗦膊酵子厚享字学
脱	悦锐税蜕说阅兑兄况祝铝嗅克沉觅
舵	船航舶舟舷蛇艘舱舰艇鸵驼
舷	航船舟舵艘舱舰舶炫弦艇玄
舶	舟舵船航艘舷舱艇舰迫帕柏泊拍怕伯腺
船	舟舵舷航舱舶艘舰艇铅沿帜向蚣胎铭锅丹
荸	脖孽浮俘厚享渤勃肺沛游学字子
荚	挟峡侠陕狭夹艾颊莱若荐茄荔惹哎着茵疾苗英芝芙芯芥昔
茎	氢径经轻黄劲颈芽灾奸巡葬蕾三巢
莽	犬吠伏苔葬蔗器臭哭突献茂状默兽
莫	墓暮摹慕募幕昔萌葛寞蔓漠摸膜模草音芭措惜借错
庄	蒋壮寝妆墙状将菲姚蔬弄慈药王班叫
莉	痢俐萎荆前利梨苏秃犁菌秉秧喇
荷	倚何苛寄崎椅畸可啊奇河坷呵
处	返逢隆板扳疼客略胳烙格洛叛
彪	衫递杉彤彩彰形影彭唬虎号密皆
蛇	虫舵蝴虫蚣蚪蚌蛤蜂蜻蝶蝠蜗蝙蝗驼螃鸵蟀
蛀	虫蚪蚊蛙虫蛆蚯蚌蛔蟀蛛蛾虹蝇蚣螃蚓
蛆	虫蚯虫蛀蚪蚌蚊蛙蛔虹蜗螟
蛋	虫闽蚤蟹虫蚀蛮强融楚蛀蛆蚯蛙蛔蚊蚓蚌
蚯	虫蛤蛆虫蛀蚪蚌蚊蛙蛔虹蛉蜘
蛉	伶铃冷虫蛤龄蚯零蚣蜘虫蜈螺蟀蚓
术	衔街衍衙卫冲衡行御征徘微彻霉徙循徒述很徊律征往
被	波披彼坡疲跛破玻皱皮菠颇板格簸
袒	坦但昼查旦阳褐得畅焊杆汤捍悍旺旱
袖	油抽由笛宙川轴里裸串娄栗要
袍	胞炮泡抱咆苞跑饱包雹刨忠
袋	裁依袭贷装裂制衣裳代迎
觅	觉规现视砚见观搅窥脂能比
规	现视砚窥觅观见觉搅能夫
访	谤注诈谚记该诚计诀许讨讯词诅诉话询详
讶	呀评订诬诀诅诈讨计课语
诀	讨许记讯注诅诈详询计订课谁
许	谁计诀讨讯记注评诅诈详话询订诬课
设	讽般股殴投壳殷毁殿段谷毅役诞杀诱误护诈诉话
讼	诫试诗志认谈谓谱识诲谊谅请谋谍诺讥
讹	诊诲论许谁记诈计训诞谜谢诀访注诅诉讨
贩	赂败财贿返板扳贬锋贝贴叛赌胳则账赚逢略贮烙格峰
责	贵债积贡员绩贯货青赞费买贷贺资贾赁狈
贯	实惯员责货贵买赞贺贷费贡赁贾狈资赘厕贝侧测溅
货	贷员责贯贵赁赞贡费贺买资赘侧狈贾厕贝测溅
贪	负今念含令贱费贝侧侦贼债伶伐货贷员厕吟价
贫	盆岔忿钻分赛实赏圆损宝贝狈陨债惯溃遗积
赦	赫赤吓败玫数收启效敞敢散致故敬牧枚改敌攻
趾	迹企扯址蹄足距跟趴啃跳跋跑跌践
软	轰轨轧挽车轴轩较辅辆轮辐辑输
这	唁信誉誓譬警言谅谆让谜计谴逗讼逼违诗试
通	桶痛蛹诵迅外用夕佣逸侈舞育多名
逗	短岂痘逼登丰竖豆言这遣戏壹凳
连	轰阵链库军莲运载辈车范轧软轩轴轨浑挥裤荤晕
速	束辣喇漱嫩嗽懒秉癞赖逮迷迂违乘卜
逝	浙撕折晰近渐惭嘶掀斤崭薪析听芹匠
逐	猪据队毅剧坠迂扬场肠杨
逞	程呈造淫圣哀告京浩任挺毫高庭亭亮豪享
造	浩酷窖告逞糙呈任廷望过遣圣靠吉
透	诱秀乃扔奶仍潘播季孕矮揪俐锹莉萎秦痢
逢	返略胳烙格峰洛锋板扳疼客终路降叛处
逛	狂斑班惶煌痊筐漪栓拴润眶框王凰
途	除徐逾迂迄伍于斜叙污吁涂夜芋宇
部	剖鄙郭郊邢郑陪啊都邮郎郁邦那
郭	廓敦墩部享郊郎郁鄙郑邢邦那椭
都	者煮堵屠奢着暑郁郊睹邦郑诸署
酗	配酌酣酥丑醋酪酵酷酸醇醉醒酝酿酬
野	抒序舒予墅预豫里黑墨多侈理狸埋哩里移嘿
钓	钧灼芍的钝酌钩约豹勾勺恭匀公针均哟金
闭	闲门问闪间闷闰开闸闺闻阅才材
陪	障培焙倍赔菩隧防陨竞部随陆陷接除隔隘暗
陵	凌菱陆降隆傻后锋贩反厦忧
陈	栋隅阵冻限陌阻阱东陡陕阿防除附
陆	陵睦陡陪陷除隘陨陶阳院凌降陋隔隙障际险
阴	除险附际陶陷院阳隆隔陋降吟伶隐
陶	淘掏萄摇遥谣院除缺陪陆阴陷阶阳降隘
陷	焰阎馅陆陪除阳隆降滔隙稻桩阿防
雀	维淮推崔堆唯售集进焦椎锥坐佳雄雇只准稚汇催
雪	雨霍震霹云霜霎霞露零霉灵
章	樟草音障竟意立暗竭童早亿忆
竟	境镜音章意立暗竭童樟亿忆免站靖障
顶	顷项预顽顿颂烦硕频头颗显须颁颇领颊题愿颠颤
顷	频须颁颖倾顶顽顿颂烦硕颗颜显项颇颊头颓愿顾
鱼	鲁渔鳖鲤鲸鳍鳄
鸟	鸵鸣鸠鸭鹃鹊鹏鸦鸯鸳鸽鸿鹅莺鹤鸥鹰
卤	咸碱卤朗盐浅参回亩栈晋郎钱幽圃国乡衰廊遇盏榔裹践溅
鹿	混棍罢尘皆庇阶揩楷丽洒
麦	侈多爹移麸宛夕舞铭面名令干杰外
麻	摩么磨糜魔术控腔述空穴蘑挖
家	嫁稼家什伤锭喧棕传俭滨值估仗做傲尺
傍	榜膀磅螃谤旁肪仿楞方于坊妨咙拢胧房芳宠庞笼
傅	博搏膊缚传侍脯补哺捕浦铺圃辅甫
备	佣仅供并首道仆件借仪用傀俏俄伴位伯作任化奥向
杰	侈怜保伶磷麦舞鳞麸仔令侯蹂你健夕乞
傀	块愧槐鬼瑰魄魂俄作伯件任魏几丑入么
伞	悴碎粹卒什午从醉聚翠侠俭估仗众耸偷伤伦侮
最	撮娶取耳支丛趣闻茸昌耻耿昭枝肢吱妓技
凯	岂肌凳咒饥飒冗壳殿设跺躲逗殷般殴段股吭投枫
割	豁刮剖创副判刑刊害剩划剑削克刹到制刺剂别删刨利列划
创	剖刮割划仓副刹削剑刽剂刺到制判利删刨别刑列刊
剩	制利划剔刹剃削克剂刻刺刮删刨判刑刊印
劳	荣荧莹萤营筋唠捞莺肋胁勇胜锄踊
胜	胖腾誊倦肋劳筋胁畔拌伴锄抛拗圈
勋	偿助肋员胁劫幼咖贺勇另勒勘动勤贿勉勃励功劝损陨
博	傅搏膊缚辅脯补哺捕浦铺圃甫传将肘薄簿
喧	宣喳喷棕嗜家嫁院锭滨
啼	缔蹄蒂帝咙磅瞒常吊棉满滞怖锦布谤砸
喊	减咸灭哈吮威桐铜洞筒后答茂
喝	揭渴遏褐谒竭葛唱歇蔼惕锡吧邑
喘	揣瑞端而耐耍碳嗤需啼喻啃儒懦哑吨
喂	偎畏衰嘿哩咽呀辱聘当褥谓表长画当
喜	嘉嬉吉台袁膳豆培壹售告周敬鼓
丧	壤噩嚷攘囊镶吉民单喜周售区哭袁品器咒周
喇	嗽咧捌漱俐涮嫩速痢莉测侧倒例懒辣
喳	渣呆查杆宣喧杨噪秆保旦檀粮根棠架
单	弹阐蝉战器哭咒嚣实严惯区兽贯囊车
唾	捶锤睡垂邮啤听叭呜甜朱鸣咱呼哗甘千呈
哟	约丝絮累系紊素索辫纯嗦紫细灼吆绒结绢紧繁
唤	换涣焕痪踊勇哎琼懈唠嘴懊澳袄吹
喻	偷愉榆逾输愈哈伦吟吃
乔	高吞侨娇桥矫轿骄膏夭篙蒿癌笑搞稿妖沃向镐
喉	猴侯吃咐喻哈吟吼呛唯呐跪俭天夜
围	伟苇违纬韩拿韧笨本困晤梧悟捂卫讳
堪	甚勘斟垮农浓脓其辰
场	扬杨肠阳畅坦堤塌昼伤汤袒坛但逐
堤	提是坦锭场绽定昼塌匙袒坛但题
堰	腿褪根退银恨痕眼狠限跟很艰良
报	服幸择泽绎释译候肾坚捌紧竖贤
堡	褒保杜涂呆藻容谷裕桂浴俗噪澡燥吐台躁
壹	澄橙灯瞪礼体筒桐铜洞证蹬
壶	址壹萤志吉再虫止土工遣壮肛兆北
奠	犹共酗酒曾基异恭美艾医天斯酣酥烘配酌哄拱洪醋供
媚	楣眉帽算省自箱篡娩咱湘首目厢冒
婿	楚蛋旋础漩踩娱蹈好奴娩奶内
媒	煤谋某柑钳甘虚芋酣甜嵌于嫌
寒	塞寨赛暴异共烘哄拱洪供港基恭溢隘嘶撕
富	辐逼幅福蝠宣宗完丰害合卜副当挡档裆铛痘拿岂宾咸言宇同石士
寓	偶遇隅愚藕迈万厉甲巾蜀宵宙宜帘宏守吊布实钾帜
尊	遵蹲曲曹寺守专辱寸对村肘付农导尉射封
寻	讨等刁诗砖褥夺帚符厨冠蔚府将时待恃持咐侍树附谢
就	尤稽晾掠凉景京默吠献鲸占犬哭
嵌	次钳柑虚甘久媒欺掀煤甜嗽漱
幅	逼福蝠辐富裆挡当档铛巾同帽幌幔幢帜帐帖
帽	幌幔冒帜媚楣巾幅瞒帕霜幢帐帖帆湘目厢箱
几	叽机讥饥魂乐魔鬼傀愧块槐以幻瑰魄魏幼
廊	榔郎参廓乡爷晋残梆椰惨挪掺娜哪渗掷
厕	测侧则员费贵贷贯货责赞狈贺买资赁贡贤贝贱溅
厢	箱湘霜相床目楣想厕冒帽媚困睬亲梁眷栽乐省眉看盲算
彭	形衫杉澎膨彩彤彰影彪鼓树厨珍射彬喜疹薇
复	复腹徐役从后行彼御得待徒很微征履
循	很徊律往彼役冲盾徙徒征微征
惑	感国或域怠憾台撼恶惠恕思忠芯忍志应名苔胎抬
恶	亚哑患恐背片惑悲栗要串栗粟忠介冀工腰迁怔融隐
悲	辈靠非菲排啡匪罪靡徘诽
闷	门闲间问闪闰开闸闭闻闺闽板阀们
惠	栽穗专截裁载忍戴铁愚慰式团传代
愕	胯垮夸跨严嚣弹污夸
惰	怖恢工贡情懦肛扛江汞愉捺恒怔攻功贵肯
慨	溉概既潜唧卿鲫节恨即悍旬匀蚕
恼	脑腊巡猎蜡巢灾囱奸
惶	煌蝗凰皇怕旺润斑班棉腺栓拴锦柏迫拍泊
愉	偷喻榆逾输愈恰伦抡沦悔
掌	棠当常党尚尝裳赏堂肖挡当膛档裆铛敞淌捎哨倘削
描	措锚摸瞄苗搭猫拼拱曲搓撞播擂茵茴扑菌曹
拣	炼练拦柬澜栏烂兰抹东播栋披
揩	阶楷谐皆批棍混折指鹿罢
揉	蹂柔扔采播换拯操扭揪禾拨担搁挽挺捆乃
揍	凑捧奏榛桩棒秦夭奉矫沃妖泰笑春吞
插	括捶拍托扒写捣拆扳折抓搜段泻臼千抹挤抖技抄播撬桩稻抵投揪
揣	喘瑞端而耐耍摧携扫擂扎需抡撬指儒懦扰拂
提	堤是锭捍扬绽定揭捏撮匙掖袒擅坦但题
握	屋至室致到窒掘倒扫致套
揖	辑拐捐摄扣耳损捌聂撮耻耿取茸
揭	渴喝遏褐竭葛谒提捏扬捍撮歇措惕锡把蔼
挥	浑运辉晕荤轰撵军裤链莲车连轧库
捶	唾锤睡垂邮括插拍拆折托扒捣甜扳抓抵扩甘千
援	暖缓授采挥挣探摇助捐锄天
揪	锹秋播秋秒稍禾秦俐潘萎愁审
换	涣唤焕痪踊勇琼懈揉解拯捞懊澳袄扭
扬	场杨肠阳畅捍提捏撮揭据伤招拐扮
敞	撇厂蔽散敌肖别弊枚币敢败启敬故数牧玫改收撒矢疾尚
敦	墩郭教枚叙廓敬启敌故享敞散敢效数放牧玫改
敢	橄干故枚玫敞散救教启叙敬敌数政致牧改攻敛收矢
散	撒敞敌敬枚蔽敢败启故数牧玫改收撇矢疾厂矣
斑	班玷逛琉璃琳理玫王痊
斯	撕嘶析近折听芹新斩祈所斧匠掀斤
普	并碰并共井谱异基恭屏昌昔暴烘拼拱洪哄供并
晰	析逝浙薪惭渐撕嘶斤崭新近折听芹匠
晴	情清猜睛靖精蜻请青债积绩责
晶	昌唱倡猖暗日萌间昔旦明旬
景	晾掠凉鲸谅京影占就暗蒿篙烹豪高亭亮享哀
暑	着屠奢署堵睹诸者绪赌曙煮猪都
智	知佑矢右唱蜘疾若昌矣枚替春昔吞君吝邑晶匿惹散敞敢
晾	景掠凉鲸谅京暗影就占搞淳停哼稿壕嚎镐
曾	层僧憎增赠曹西昌钾晒昔晶鹿槽遭醋醒
替	夫芙倡扶但失规昌推们春昔晶承麸撵
期	其欺棋箕旗簸甚具堪俱甘脊
朝	潮嘲庙干斩干肺韩朋沛翰甫宜脯胡明渐惭崭
棺	管馆官榕枯棕柠栖枝杖糊刮
棕	综崇标蒜捺襟察漂膘赊际宗
棠	掌当常党尚尝裳赏堂肖当档膛挡裆铛呆敞梢淌哨倘削保
棘	枣策刺棚采想栅相肘采菜粗租睬称膝湘桐厢荣箱孟
枣	棘策刺采棚想菜采栅相肘孟厢箱荣湘睬粗桐称租膝
椅	畸崎倚寄骑奇荷啊可河坷呵何苛
栋	林东陈冻森棵材村淋柬栏琳彬焚番
棵	裸果栋裹困课林东巢捆柬森番
森	林淋琳彬栋材村木焚杰采李杏床宋呆棵杜沐困朴
棒	捧榛桩奉揍凑楔泰春秦奏降攀模挟林梆木森
栖	凄妻枯枝杖楼末植林棺根株柿数枕析沫
棋	箕其期簸欺柑旗横桦植朴甚具堪俱棕檬甘某
棍	混楷鹿罢昆皆揩比阶
植	矗值殖置直宜棋枯枝杖棕真具栖慎填俱镇檬柠桐且
椒	淑寂叔朴督柱校柿梳杭核迷林榜樟檀鸟乌木
椎	稚杂进淮推堆唯锥崔雄准离集
棉	锦绵帮柏帕穆惶啼煌腺滞满怖瞒布迫泊拍怕伯
棚	朋硼崩受桐爱骨鹏栅相滑授称棘乱猾稻稠枣策
款	炊歌砍玖坎次欺钦亩欣吹灯饮欲歇软歉欧欢疚示
欺	其期钦棋歉箕歌砍玖次旗簸款欲亩欣炊坎吹
钦	歉欺炊坎吹久疚欲歌亩砍玖次钮软欣灸
残	歹殉死列栈浅钱歼殊殃贱践殖渗掺惨
殖	矗植值置歹殊殉殃死直残列歼咧例尸宜
壳	毁殿殷般段谷股投役杀设毅殴疫没圾发泼拨及废击声
毯	毛淡尾撬谈耗痰炎氮毡
氮	气氨氛氧痰氢氯炎淡毯谈
氯	碌录绿氧气氨氮氢剥氛互汽
港	溢洪烘拱哄供共异暴隘寒塞寨赛流瀑谱撕嘶基恭巷
游	游漩淤肪妨坊仿房芳防旁纺浮方
渡	镀踱浅治度渗械戒遮泳洲减灭诫扩旷矿浦浪庶
凑	揍奏榛桩添沃秦棒捧夭泰矫妖漪笑春奉吞
渠	巨炬拒梁架柒染争采床宋呆森局凸凹淋净矩泥林沐
渣	喳沐漆淋查杆宣汤杨湘秆沫决旦
减	喊灭洽咸洞威给蛤拾恰哈后筒答茂
湘	厢箱相淋霜沐渺楣目想测溅亲沈渣帽媚睬漆困冒
渤	勃沛脖浮荸锄拗抛筋胁肋胜踊劳
湖	糊沽蝴葫胡潮胡枯姑咕估古苦居固做沛汁
涡	滑过锅祸蜗窝猾浩沿治沼乱骨滔淫深净浮洛沉淌沮朋洞
汤	荡烫混湿荡渴漫瀑渣袒涧坦滨但旦扬场阳焊杆杨肠
渴	揭喝遏褐竭葛谒湿汤漫瀑混歇
渺	督省湘沙测溅相冒惧目眷算眉看盲篡
测	侧厕溅则员涮狈费贵责贯货赞溃贝贺买贷赁贡贤
湃	牢件牛牡犁活牲拜泊牧沃丰看派物汁添浩
浑	挥运辉晕荤轰军裤撵链莲车连轧库轴软轩阵轨载
滋	磁慈漠满蒙灌药浅幽溪渗港溢沟漾浓卤洋洪溅
涣	换唤焕痪澳踊勇没琼懈渔懊袄汛弥
焙	培倍陪赔菩竞暗接粒泣拉垃位立
焚	杰楚禁矾秋林炎森栋淋梢秒材村襟
焦	集售蕉憔瞧礁只双黑崔羔椎进淮推堆唯锥
焰	陷馅阎滔臼桩稻蹈舀旧焕躬炊
无	芜抚舞庶炎借并供伙焦羔杰灸灰焚然黑煞鱼熬氮痰蔗火淡
然	燃灰痰煞央恢奥熬炎胰肋英杰尔焕映
煮	者都暑着屠奢堵署睹诸薯绪赌曙储
牌	版片牍脾碑啤卑衫
犀	属迟嘱匪尸排悲尿尾菲手啡逝适非匹
犹	奠狸狂狈狠狡狗犯狼狭狐猜猖获
猴	喉侯狂狮狱狭狸狠狡狗犯猜猖获
猩	腥猖醒星猜铲隆狠牲生笙性姓产狂
琳	淋森斑班林王玻枉弄彬理珠瑰珊玷玫玖
琢	啄玩玫玖斑班理瑰珊玷王
琴	瑟玲吟黔伶零今捻蛉铃冷
甥	生舅虏牲性姓笙星腥产猩铲男隆醒拜猜毒
画	昼书鼻三畏在喂偎奋埋疆票衰查卖或冀些苗二田一
番	禾香委审潘播秋和私季秃秀黍菌稍稚租秘科秒利
痢	莉俐利秦梨矮秃荆前犁秉喇秧榛厕萎审斗乘禾揪
痛	桶通蛹诵丸疚痪爹挚癣用夕执
痘	岂短登丰竖逗左奈豆凳夸壹合矾
登	凳痘岂丰短逗澄灯橙竖瞪蹬合邓证盒拿久
发	废泼拨搬淀锻缎壳疫股投灸久殿殷般段没
盗	盅孟温盔盛盟益监盈杯扁荡瘟栅
困	睬目捆瞄眶眼相盹盯睁瞳困睹眠睡盼了睛睦
短	痘逗登岂丰竖知矢矮豆矫矩凳倚澄灯橙枚壹盒疾
硝	哨砂当石梢消捎悄峭销俏砚稍碘硕砰歌确码研砍
硬	梗埂便更研砰硕鞭硝歌砍砂石
砚	视现规觅观见觉硼硝砂搅碉窥
稍	梢秋秒档禾租消捎悄峭哨销俏和私揪锹
秆	杆焊捍悍香赶旱穗秽秤禾查程杨干称稼稻秒租秋科和私番委
程	逞和呈称稻秒秽禾秆淫稿穗税稚种秩秘秋私稠番圣香委秀告
税	脱悦锐蜕阅说兑秘和稍稚租秩秋科私程秒禾秃
稀	希幕怖布称稻秒稍秧租利禾秃布秆程移稿稼稽积穗
窘	裙窖窝窟君窑窄突空究伊窜窗窒帘洼
窗	囱总窄突究窖空帘穷窃窒穿窍窘窜
窖	造浩窘窝窄告酷窑窜窗呈穷窃窟窒圣空洼任
童	撞钟幢瞳立音章里里埋哩竟意理站狸嘿
竣	梭峻唆俊酸骏靖飒立菱音竭端凌锋贩站返反童意竟章
等	特时持恃侍待夺寺符诗对封筹寸厨府树咐
策	枣棘箱笨禾租稠称稻刺番柔香委秉稍棚秋相栅和私
笔	津笛箫律建肄肆爪篓健键么竹策笋笨第笙笆笑竿
筐	框眶斑班王痊凰惶煌逛栓拴
筒	桐铜洞答壹同石硼言喊减洽拾恰哈
答	签合洽拾恰哈给蛤筒俭八言合石捡脸检钥
笋	殉旬询昏宅筷恨托笆么竹策笔笨笛笑竿忽箫
筋	劳肋勇胁力胜踊奥筝锄男劣另筒渤澳拗抛懊励助袄
筏	符八阀伐答今么签伏代念含令袱践吟伶扒叭
筑	筑肛江扛恐工红缸虹汞鸿巩攻功贡巧
粟	栗要贾复腰栗迁价粱气屎糜粥袖迷咪米怜磷鳞
粥	气籽怜迷咪磷鳞米屎粱粟糜粗粒料灿
绞	丝纹纺绰统细校咬纤织绊组纱纯纽纳绪维
结	绕续绍络绢丝绒给缠细维纽绸
绒	缠丝缚结绢绽综缩织缤细约
绝	绍纷纫丝纪线缆结绒络绢终绵编缩绷织
紫	丝累紊素柴系絮索些紧繁系哟罗蕴细辫
絮	丝累系紊素索哟紫紧繁系细恕罗蕴绒结绊组绢
丝	纠细绊纱绿约组纹纯纽纳纸维练缘纪纫绣绒
络	终烙略胳格洛骆路结绍赂酪客
给	绘洽拾恰哈丝结蛤绢纳维绒绍纬缩细组答
善	膳羹羔美姜菩对义弄培喜窑苔焙塔漾倍样仪糕
翔	翅翎翩翘翻扇羽折塌习翁
肃	啸萧箫锈渊姊绣中斗齐束串臼甲由史巾忠冲仲引儿
腕	惋婉碗豌宛脖腔肺肢死夕脆胎侈外麦军尸字
腔	控空窒挖麻穿肢肺窄突帘究穴窃
腋	液掖夜股迄腹胳健腿悴肮服脐又舷碎逾逢膀航粹侵踊蹂
肾	贤坚紧竖服宦臣卧臀有藏报候临脏鉴前捌赃
胀	帐张账长涨刁争服朋叼胯脓畏脉胚肪肝肛肚肋喂净挣
脾	啤碑牌卑脉肌千肿貌舀冗
舒	抒野序予预豫舍舍侈墅多移爹
菩	焙培倍陪赔立泣拉垃位竞善粒暗接
萍	平坪蒲荡秤砰茫范藻菠落薄评
菠	波簸皮落疲被破玻披坡跛彼藻婆颇皱板
华	哗桦荆苦芋着苛葬甘芽葫薛黄蕾
菱	陵凌忧傻厦反贩锋各冬赂后返板扳
着	暑屠奢署堵睹诸薯者绪赌煮猪
莱	来荚茉叶菊苗芝芙芥芯昔芋艾苇卒巫夹坐椎枚
萌	昔莫明草音芭幕墓暮摹慕措惜借错葫冒葛募蔓
菌	苗苏番萎禾莉禀香委审榛秋潘播和私
菲	罪靡排啡匪徘诽非悲辈靠蔬遣
菊	鞠芯苟芍米苞叶燕怜葡卜屎蔚蕊迷咪莱粱茉苗昔荐芋
萎	莉矮委审菌禾秦苏揪潘播锹秋
萄	淘掏陶摇遥缺谣蕊芯缸坛遂罐
菜	蒙荣采采荤茶前睬叶药踩肘煎典膝
虚	虐虎甘钳柑虏肤虑卢媒煤某嵌疟酣甜谋
蛙	虫蛀虫蛔蛆蚯蚪蚌蚊蛛蛾虹蝇蚣蚓
蛔	虫虫蛙蛆蚯蛀蚊蚪蚌蝇螺蛛蛾蜕虹蛤蚣蝠蜗
蛛	虫蛾殊朱蚪蚌珠株蟋蝌虫蛙蛔蛀蛆蚯蚊蜂蝙蝗
蛤	虫蛉蚯洽拾恰哈给蝠蜘虫蜻蚣蜗蛔蛆答
街	衔衍冲术衡衙卫行征徒待微徘御征往徐
裁	袋依装裂制衣袭惠栽载专截裳
裂	烈制裁装依袋袭衣裳陷闹迎
袱	伏伪犬狱吠伐泪嗅复附爪跋状献筏莽臭哭突
视	砚规现觅观见觉祖祝祸搅窥
注	访诅诈诉许诀该详询记讨讯课谁计订谅识
咏	诚讨讯计订诫注诅诈详询诀许记课谁试讼
评	砰订诅讶许讯诬计注词诈诉详话询诀记
词	记诅诈计订注评诉访诀许详诚话询讨讯
诅	谊注评词诈诉详询许诀讨讯诬记计课
诈	诉诚话访注词诅询详诀许记讨讯计课谁订
诉	诈注诅话计订评词详诚询访诀许记
诊	谚诲论讹珍趁许谁试诗设讼志认诫诱谊
象	像橡豫色间旭免渴揭喝遂遏葛陶歇意竭褐涧恰憔亿
贮	贼赌贝贱则贬赂赊赔赋赠赡贴贿贩败财账
贴	赔贝贿败财贩账赌赚贼贱则贮赂赠赡贬赊赋赐购赎员
贰	腻吨岭苹吁倾濒式须页项颂顿顶烦硕颤
费	贵买员责贯货贾贡贤赞贺贸贷资赁质厕测侧狈
贺	员架贵责贯货赞狈费买贸贷赁贡赘资贾贤质驾厕圆赏贝测
贵	贡责溃遗员费买贯货赞贺贷贾赁资狈
买	费贵贸贯员责货贾贡质赞贺贷赁罩置众贤狈
贬	眨泛赂贩贼贱贝贮赊赐败财则乏赔赋购赠赡赃赎贴贿
贸	留买质瘤溜榴费贺贵赁贾贡员贤赞贷资货贯责赘狈馏
贷	货员贵赁责贯赞费贺买资袋贡赘厕侧狈
越	赴走起赵趟超赶趣趁趋陡徒践跋伐踱进跟垃卦伏代堤琉壕壤
超	昭沼招趣走绍起赴趁赶越赵趟趋召
趁	珍诊疹走超赴赶谚穆趋越起赵彬澎膨趟趣陡
距	足跟趴跋跑跌趾践踏踩
跋	拔践踱足距跟趴跑跌跛趾踏踩
跑	咆袍胞炮泡抱足距跟趴苞
跌	趴跺足距跟秩跋跑跛趾践踏踩
跛	被破波披坡玻疲皱彼趴跺足距跋跌跟迹踩皮
轴	轰轧车软轩轨较辅辆辐宙挽辑
辜	宰辟锌辞辩辛辨办辫薛滓僻避瓣古辣
逮	隶康遣市止衷速慷艘逃卜进遇送迷退逆回迫柿近歧迂
周	稠碉绸调周雕肚造运过遥膨吉
逸	冤晚挽娩冕兔挽免勉竟臭嗅境镜搀
进	椎淮推堆唯锥离杂崔霍雄稚准
邮	垂捶唾睡锤郑邦邢都部郎郁那
乡	榔向响廊参晋朗郎魏刻溅州划川滋兜鬼幽慈巍么
酣	醋酥酗配酌丑酷醒酝酪酵酸醇醉酿酬
酥	丑酣酗配酌酷酪醋酵醇醒酸醉酝酿酬
量	厘旦粮里旺黑里理埋哩撞幢瞳钟缠
钞	炒沙抄妙吵砂纱销少省劣炸锁渺针铛金
钮	扭丑钦纽羞铭钉针锥锰疆键金
钙	丐钉锭亡下钳银铐表忙芒忘妄
钠	呐内纳锥谷锉肉丙佣钥钦针销柄铃裕浴俗
钧	均钓匀钝钩勾勺灼冰芍钳钉针酌冻准铺
钝	屯囤盹趋钓钩纯钧吨恭匈顿针胸汹金
闰	润开门旺闲间闷问闪闺皇全闭闸闽闻王枉汪
开	闰门闲间闷问闪闭闸闺闽闻润阅板闯阀合
闲	闭门间闷问闪闰开闸闺闻栏闽板朵阀兰们澜拦
间	门闲闷问闪简涧闰开闭闸闺闻闽板阀们
队	阱阳陌阻陈逐阵陡陕限阿防隘陋险隧坠
阶	揩楷谐皆棍混鹿罢隙比
阳	畅扬场肠杨队限袒陷除陌阻
隅	遇偶寓迈愚藕陈阻阵陌限阱陡陕阿防附
隆	降陵处猩峰锋铲版络逢路赂蜂腥终略胳烙格洛
雁	座挫锉坐巫难瘫滩摊集焦崔售二进椎淮推堆唯催准
雅	牙邪鸦呀穿芽蚜椎讶稚准杂雄进淮推堆唯维锥离
雄	截虽太进椎淮推堆唯准锥稚维离杂鸡崔奋
集	焦售只双夺椎崔进淮推堆唯锥侍
雇	乍户崔怎肩截扁房进椎稚淮推堆唯锥邀
云	震雪雨零霉霎雳灵霍霜霞
韧	纫刃违伟卫围苇韩纬讳招拿券槐叨砌
项	顶顽烦硕颈颤顷顿颂频头颗显须预颁颇领颊颓颖题
顺	川驯训袖刘裕袜串州中划剃刷划爪冲仲引儿
须	颜顷频须颁烦顿颂顶硕颖颗显项预顽领颇颊头颓额题类
饭	饥饮饿饺饼饵肴饲饱蚀馁馅
饮	饭饼饵饥馅饲饱饺蚀饿肴饰馁
冯	妈吗玛码蚂闯驾骂马惊驮驰驻驶驹驳
黄	横茎蕾量葬会芋甘四票广三华苛
黍	稚黎禾番香委秋和私季秃稍租秩秘漆稼科秒利
黑	墨里嘿焦羔里埋哩默点童量野理狸黔
乱	骨辞朋目滑过涡绷锅蹦崩觅相猾祸棚贝自窝冒受
佣	庸伐伏代布巾伪偶俩今殃仲饰傅伶例佩筏贪仓席食念含吊令
债	积绩责价溃遗损睛陨惯晴情清钻圆
傲	做邀熬嫩撇撒橄激缴放族埃赘
传	砖转团专傅侍栽博付咐附符府搏膊俯时特褥遵恃持穗铁团
仅	谨勤备并供健仆债借津佣位伴仲件靖仪笔
倾	顷濒吨苹贰岭吁频化须烦顿颁须颖页
催	摧惧崔携仙瞧雏雌摊滩汇瘫椎进唯堆推淮锥坐
伤	偷俭伦但侮伶份杨肠场扬阳
傻	陵凌菱后俊厦忧赂锋贩反略板返扳处疼各冬
剿	利巢刺划剩划副刽剂剥剖刚刹削则刻刷刮制到判删
募	莫墓慕摹暮幕葛蔓昔寞荔萌摸漠模膜努茄
勤	仅助功勒谨胁勘劲励劫肋幼荔茄
势	劫胁幼勇努男劣另热茄荔丸协咖拗助肋
汇	淮尿滩催摧准椎进唯堆推锥惧雌摊焦集雇售崔
嗓	沐泵噪沫决淋喳渣漆湘口菠品呆
嗦	索丝洁螺骡哟绢结细絮累系
吗	码妈驾玛冯蚂骂闯惊马驮驰驻驶驹驳驼骆腾驯
嗜	鳍唱旬喧味咕吱嗦喷婚嘲喝喳惜憎倡悍哮
嗤	缸虫工哑听肛扛江喘汞蛙蛔蛆蚯蛀蚊蚪蚌虹
呜	坞乌鸣吕铝侣呼叭宫唾嘀啤咬咳咱听品薛呈
嗡	翁塌翰蹋折习翼
嗅	臭唬泪吠媳熄兄钻况袱克兑犬虎
呛	抢沧枪苍疮舱仓吟哈喻吃创咐食
园	远猿辕袁哀周畴畦垒吉里结嬉埋台
圆	损陨赏韵员实惯贝债溃贫遗赛钻
塞	寒寨赛基暴异共烘哄拱洪供港恭溢隘嘶撕
塑	溯肚周堕逆冈基茁崩台岗角漓钢台
塘	搪糖唐城域班去埃块垢坤坷怯法址均划州康庸丢玉允土
涂	途堡叙斜除洽杜汽伍丘于沦徐污岳芋宇全乓乒淮
塔	搭瘩哈恰拾洽鸽答荷合合拿磁给蛤俭捡检脸钥堪
填	慎镇真颠宜直植堵值坟且壹
塌	蹋嗡翰翁习折翠翼
块	瑰愧傀槐鬼魄魂魏几丑么魁垢刃魔
坞	呜乌埠块垢薛垃叔坏塘鸣启师迷城帅坷坪坡
奥	懊澳袄向制筋衅自血然痪央胰肋
嫁	家稼家婉婶锭喧棕绽滨妹姑妓尺
嫉	疾嫩埃唉挨效矢族辙佑数枚知收傲撇撤澈撒做
嫌	廉赚谦兼歉镰帘媒嫡姊如女奸
妈	吗玛冯码蚂骂驾闯马惊驮驰驻驶驹驳驼腾驯
媳	熄息嗅钻虎婚沉娩妒妖臭嫂娇唬姓兄鼻忌赞
嫂	搜瘦艘媳婚妖妒臼滔娇姓曼舀
幌	帽晃幔光帜恍幅帕巾幢帐帖辉帆
干	翰干舍秆赶杆焊悍捍韩朝斩宿舍轮输轩干岸
廉	嫌兼赚谦帘歉镰戒庶广度席械床台盏蔗戈渡遮镀
厦	夏忧菱凌傻陵后反峰各冬处赂路贩胳板返扳
汇	雷果互裹蕾电巢棵裸擂录肯青碌将课剥颗
微	霉彻征御街衔徘衡衍循徙徒很律徊彼往复从徐役
愚	寓遇偶藕隅迈万惠忍厉慰甲巾感蜀患恩思忠吊布钾
意	音竭忆章暗亿竟立葛樟童昔境障站镜
慈	滋磁药幽惹蓄葱葬萄莽蕊怠苔关惠几乐芯忍玄庄蕴乡
感	憾怠撼惑恕台名苔或胎抬始治惠思忠芯志忍惹
想	相厢箱湘盹息忌目亲态枣策怨冒霜棘衬
爱	受朋崩棚硼鹏骨授胸胞觅月滑静
惹	若匿右艾诺葱怠慈荔落茄憾慕莽蕊感荚恕芯撼哎
愁	秋揪稍秒锹禾愿您杰悬秋番悉凭香委秘穗和私
愈	偷愉榆逾喻输仑伦儒优盒念合抡沦
慎	填镇真颠宜恒直植值惯愤且
慌	谎荒惜芒懂忙蓄亡茫忘慨世葬盲荠妄
栗	腰迁栗价粟要贾复袖裸悟千亚恶惰懦怀哑恒怔
愧	块槐傀鬼瑰魄魂怕魏几丑必么魁恤恬性匆刃魔
搞	镐稿蒿篙侨掠娇桥攘矫骄高轿膏摔掖停擅拥壕嚎抗扑
搪	塘糖唐找抬捕拔撼扣搔挨拭捷捉括拂抽押拓拇抱拘扯
搭	塔瘩拾描措捡摸舍恰洽哈鸽拓答荷合
搬	锻缎淀般发投盘殷段股抗疫毁殿壳拨谷役击
搏	博傅膊缚捕持补脯铺浦哺圃辅甫
搜	嫂瘦艘撬播抵投插拍折抓托扒浙抑臼
搔	骚虫蚤强虫蜜萤蚀蚣蛙蛔蛀蛆蚯蚌蚊蚪蚓闽
损	陨韵圆赏员债捐惯溃积遗钻绩贝实贫赛
抢	沧呛枪苍疮舱仓捻舍捡拾抡擒拴拖创食
摇	遥掏谣淘陶萄挥采缺援探授挣缸坛
捣	貌拍把笆藐皂托扒白巴括拆抓扳折指插捶耙柏迫怕泊肥吧
敬	启故擎散枚敞敦敢敌数敛牧玫改收做矢疾矣
斟	甚勘堪魁斜料蚪科抖斗农浓脓其辰
新	薪析近斯折听芹斩祈所匠斧晰掀斤
暗	音樟亿忆意境障镜响
暇	假虾霞候夜浸般侵股投没又疫奴殿毁壳毅殴谷设殷段
晕	荤轰运挥浑辉军莲裤链车撵库连轧载轴软轩阵轨
暖	援缓明助晕锄天萌冒
会	合僵拿仑刽仁盒命绘量黄全丘僧潭
榔	廊郎椰梆乡栈椭挪娜哪掷绑参晋
业	共丛寨异基烘恭益洪拱哄供并溢塞叶钳隘港寒暴错巷茉
楚	础婿焚蛋禁矾漩旋林襟李森走足栋进淋橡陡材村
楷	揩阶谐皆棍混罢鹿柏比批昆庇屁
楔	契棒榛桩桥夭椅换驳梭模格澳懊杭杉袄林板拍沃扳妖托扒
极	梧标拯枉杯杆本仁柄朽查三
椰	爷梆榔聂绑挪娜哪邦椭掷茸趣摄镊
概	溉慨既潜唧卿鲫节根即朽杆查蚕
杨	肠扬场畅阳杆查棍秆伤渣喳粮
楞	榜还膀傍磅螃环防蔑谤逻锣方罩梦
枫	飒讽疯飘风台刮板杭佩肌跺躲谷格咒冗
榆	偷逾愉喻输愈栓检伦枪梅沦抡
楣	媚眉帽相湘厢算箱省自篡咱首目冒霜
歇	蔼钦歌欲亩砍炊玖坎吹次款欺歉饮欧软欣欢遏渴揭
岁	止肯歧企扯址武啃茂步趾历虫正灭蛾减喊蛛遣赋涉沥
毁	壳殷般段股投殿谷役毅殴杀设疫没躲声
殿	壳杀殷般段股投毁殴谷役毅设疫淀臀没浸侵锻击
溢	隘港益洪温滥锰赛遍偏烘拱哄供盖暴异盆
溯	冈逆塑湖潮钢岗崩洋洪港漓满纲滩汉溢沟滑漠清蒙
滓	辨办辫宰瓣辩僻避辛薛锌辜辟辣辞霹
溶	熔榕蓉浴容滨欲却滓泞沈泻汁脚裕俗谷
源	愿愿原泊涉汪汗污汤潦鸿酒河江隙潭潜滨白泉
沟	构购讲称拼并屏耕阱并井
灭	减喊威咸碳戚御茂渗不禁祭票祟宗奈
溺	弱侯弥诡桅脆涛歹涨河跪没汽多危
温	瘟酝溢滥偏盗遍沦锰卢仑
滑	涡猾骨过锅祸蜗朋滔净淫深清浮沉乱棚窝崩受
准	淮汇焦集崔售椎进推堆唯锥截雇只双奋蕉雀坐稚催
溜	榴馏瘤留贸铆柳潘聊刘沪泪油卿
沧	抢呛枪苍疮舱仓海洽沦汽创食饰伶涤
滔	稻蹈淫沉舀焰深净浮臼溪浑桩陷滑馅泻洞阎旧
溪	滔浑深净淫浮沉泪鸡幼滑滋拗洞
煎	剪箭前蒸燕蒂氮菜蕉芜烈莉荆削刺制
烟	晒西酒酷醋烦酣酥酗配酌丑墨医蘸
烦	显愿顿颁颂顽硕项须顷顶颊频头颗类
煤	媒谋某柑钳甘虚芋烁酣甜嵌烘于
炼	练拣烂柬澜拦栏兰东米粪栋鱼炎
照	昭召沼招刀超绍熙烫炎分京谈初叨
煌	惶蝗凰皇线旺绵润斑班腺棉栓锦拴柏迫泊
焕	涣换唤痪踊勇燃琼懈焰澳懊袄炊
煞	灸熬灰然痰矢久欠炊疾炎疚矣钦燃恢枚知坎吹
爷	椰聂梆父邦廊闻茸声爸斧绑挪娜哪郊掷摄镊
狮	筛师佩猴帅狗狐狂猩猜狱犹狼狭狸狈狡狠犯猿猾
猿	远辕园袁哀猖狸狠狗狂猾猩猜猛狰获狞猎狼狐
猾	滑狰猜骨狈过涡祸猛猖狞锅猿猩蜗独获狼狭
瑟	琴密秘泌蜜必玩王瑰琢斑理班
瑞	揣喘端而耍耐斑班璃琉环
当	党棠掌常尚裳尝赏当堂挡档裆铛肖膛
畸	椅崎倚寄骑奇荷啊可河坷呵何苛
痰	炎灰淡氮恢然毯燃荧谈炒煞熬
盏	盖蓝篮滥监磕仑皿册栈浅钱舰
盟	盅监盔益杯荡扁孟皿册栅盗盛盈珊
睛	晴清情靖精猜蜻请债青睁睬瞎积
睦	陆瞧目睛睬睁瞄瞒瞳盼眶瞎陵眨凌瞪瞬瞻
督	渺眷省冒盲眉看相叔寂算篡目椒淑惧
睹	赌堵诸着暑屠奢绪署猪者煮
睬	睁瞬困目睛采瞄瞒蒙睦瞎踩眨瞳瞧眼盹相
睁	睬净挣狰静筝瞬争睛瞒目睦瞄瞧蒙盼困眶
矮	萎秦委痢矫矢短榛潘播知俐透矩揪锹
碎	粹悴醉翠硫卒伞磅礁础歌砍石
碰	碘并普研磁石碑硕硝歌朱确砰砍砂
碗	豌腕惋婉砖宛硫碳磷砾歌砍石碎磁碟碾磕
碘	碰典硕硝确研磁石碑砚歌朱砰砂砍
碌	录绿氯剥歌研砍砾硝砰砂石泵
碉	调周稠硼绸砸砚确石铜桐洞碘硝礁周
硼	碉棚朋石砚崩硝铜桐洞筒泵受砌鹏碘硕歌确
碑	啤脾牌朱卑砰砂石
禁	宗奈票祭御祟襟示矾焚三碳楚二不灭棕耘隶杯
万	厉迈苗藕薯愚寓茵茴英梦甲巾遇偶励
禽	擒漓仆璃企位住傍停侦倍依仿每乞崩人亿信储
稚	椎杂黍禾进淮推堆唯锥秋和私种稍雅雄租
稠	周称碉绸调稻租稳和禾稚稍秧秋私程稿周番香委
禀	回凛茴菌苏禾蛔榛透徊裹番香委诱和私
窟	掘倔窘屈窖窝窑窄空窜窒突帘究洼窥出
筷	快决笋也忽诀缺筋箱符柒宅忿竹池托弛她地他
节	唧卿鲫即昂迎抑仰铆柳脚概溉慨孵聊御印
粱	梁屎糜米迷咪粟蚤气粥怜粒粗料籽磷鳞
粤	朽巧夸聘污乎亏悉呼畏窃米愕胯蟋垮糯
经	轻径茎氢丝红给综纤缅
绢	结丝绍绒络给缓绷组细纳绳纲绸
绑	梆丝邦缝绊细纽纠绣绒绩致缎纵纤绿维绪绰缅统
置	矗植值殖罩买直骂众罪罚罗还
罩	掉悼置买众罚骂罪卓绰罗楞还
罪	菲徘靡排啡匪诽非罩罚罗置买骂众
署	薯曙着暑屠奢堵睹诸者绪赌煮猪
义	仪蚁俄议我蛾饿羔美姜对善羹鹅牺
群	详洋祥鲜君裙搓羊氧
圣	呈锯逞望居窖程任造浩廷
聘	污亏宙夸聂轴耽朽聪联职袖耿耻油抽取巧耳笛
肆	套津律建笔肄屋握健键刁叼帚云
肄	建津律健笔肆键布启牧改比俺雌矢匕
腰	栗迁要价粟栗贾复袖肛娄还环千亚
肠	杨扬场阳畅腥伤汤袒脆坦但逐
腥	猩醒星铲生隆牲性姓笙肠产甥猜晴拜
腮	思雷虑囤聪葱擂朋月蕾甸憾胎
脚	却唧仰欲溶熔榕蓉铆御柳迎抑聊卿鲫卸裕浴俗节容昂命
肿	董种重冲动懂脾肌脉里千舀军冗里狸埋哩
腹	复复胳股脸反腋返板扳肌夜各冬冗
腺	线帕泉泊迫柏拍怕伯鹏白煌棉惶锦舶
脑	恼腊巡猎蜡巢灾囱奸
舅	虏甥臼鼠男舀阎旧力滔焰稻陷桩茵恩劣另筋胁窜身动
艇	蜓挺庭舟舶舵舷船航艘廷舱舰涎
蒂	啼缔蹄帝席常满瞒希幕篱巾滞棉锦砸怖布
荤	晕轰运浑挥莲辉军裤链车撵库连轧菜载轴软轩阵轨
落	搁露菠洛藻各茫荡范萍蒲蓬菱阁客反路略胳烙格
葵	澄灯橙登严疚歉钦瞪炊坎吹
苇	围违伟纬韩拿笨韧本卫梧晤讳捂悟
葫	苦湖糊胡蝴胡居古枯沽姑固咕估
叶	碟蝶谍世芯葬菜茶药蕊菊苟茉芍
葬	脏苛莽叶黄蕾华芋荷荆茎豆芽嵌丁惜哗桦
葛	竭遏渴揭喝褐谒意莫慕募幕墓蔓暮摹昔蔼
葡	芍蒲甫芯补脯铺浦捕圃哺苟薄荸
董	肿种懂重冲动芹莲荤葱里千
虏	舅肤虑甥卢虐虚虎男滤庐芦炉处
号	唬虎沉递彪据滤炉驴疟
蛹	虫通桶痛诵蚓蛆蚌虫蛾蛙蛔蚯蛀蚪蚊蚂蚣
蜓	艇挺庭虫虾蚓廷虫蜘蝌蛹蛙蛀蚊蜈蜂
蜈	娱虫误虾蜗蝉蝇虫蜂蛤蛉蝠蚣蟆螺蛔蚊蜓蜘蚓吴
蜀	浊烛独触甲署罢钾鸭押匣闸卖曼
蛾	虫蚁蛛饿蚌俄虫蛙蛔蛀蛆蚯蚊蚪蜂蝙蝗蚣蟋
蜕	脱锐悦虫税说阅蚣蛔蝇虫蛾蛙蛛蛀蛆蚯蚊蚪蚌蚜
蜂	锋峰虫蚌降蝙蝗蟋蛾蛛蜈路蜻蛇逢蟆饭蜓虾蝌虫
衙	衔卫衍街冲术衡行征径徐微彻征御徘很徊律往彼得待
裙	窘君伊佑群初右路略胳烙格洛知蜘吝吞
补	脯铺浦捕哺圃辅搏膊博傅甫缚蒲
装	裁依裂袋制袭衣裳玷斑璃琉迎坊坑
里	埋哩里理狸裸袖鲤嘿童黑由量墨
裕	浴俗容豁谷溶熔榕欲却蓉脚顺铅钠锥
解	懈招蟹赖昭沼初叨勇分超绝绍切刀盆忿券岔
该	咳注访诈谁许核计谅识让谜
详	谦谨询注诅诈许课谁诀讨讯记计订谋诺谱
试	诫志认讼诗谈请谊谋谍谓识诚询咏诅讨计
诗	志读谢讨诫讼试认谈谋谍谓识注课诀谁计
夸	胯垮跨试诡志语认诫愕谊谈请讼谋诺谓
诚	诈咏访讨记计诫详话询注词诅诉课谁诀许
话	诈诉许讯计详诚询注评词诅课谁访诀
诡	记脆桅跪证讯试诗夸志语认诫误诱谊谅
询	详诅诈注诀课谁许讨讯记计订谍
贼	贱贮贝贬赔赠赃贿贴赌败财则赂赊赐购赎账贩赚
资	姿咨瓷贵责货员侧贾赁费贷贯贡赘赞贺买贸贤质厕狈
贾	价栗要粟费贵买责贯贡员复资贸质货赞迁
贿	败贝贴贩赌财账赚贼贱则赂贮赔购赠贬赊赐赎员
赁	货员赞贵贷责贯狈资贺买费贸贡赘侧贾贤质厕贝测溅
赂	贩略胳烙格洛路酪络骆客赔阁
迹	趾蹄足跟距跛趴亦奕跋跑跌跺跪践
跟	足距趴踢踏跋跑跌趾踩践
跨	胯垮夸愕跪踊足跺踢踏踩践蹄踱蹂蹋蹈蹦蹲
路	酪略胳烙格洛赂络骆阁客各
跳	逃桃挑姚趾兆足趴踪迹跟距跑跌跪
跺	踩蹂跌趴足躲踏践蹈躁跛跪踢踱踊蹦蹬蹲躏跟距
跪	脆桅诡踊蹂蹬足危跨跺踏踩践蹦跷距
躲	躬身跺躺朵躯毁役穷殿壳谷般殷段股投肌枫咒冗
较	轰校轨咬轧车轴软轩狡辙辅绞
载	轰库军连阵裤范车辈轧转惠栽莲荤晕运轴浑挥软轩轨链
辟	僻避辜锌辞宰霹辩办辛壁臂辨瓣辫劈薛
农	浓脓曹曲尊甚辰堪晨唇斟勘振礼
运	浑挥辉荤晕轰链莲军裤连撵车轧库遥轴软轩阵轨载
游	游享旁芳房漩肪妨坊仿防方访淤纺
道	首导自逆咱算眉省送楣媚边篡遂备狈目
遂	隧送逆立萄芯道遭达进泣拉垃位竭遵迈避辛卜意音
达	羊主洋差遂详进祥逆送鲜柱注拄住搓
逼	福幅蝠辐富逗挡当档裆铛言遣这副卜违迁谓课迂石上同
违	伟纬韩苇围拿韧笨这讳本逼遣逗梧晤捂悟卫
遇	偶寓隅迈愚藕还万回厉怀坏逻甲巾
遏	渴揭喝褐竭谒葛歇退蔼惕锡意
过	涡锅祸蜗窝滑猾遣造乱骨高蹦朋周膏
遍	偏蝙编篇扁邀盛匾肩滥房篮溢温猛泪锰
逾	偷榆愉喻输愈途伦迄沦抡
酬	洲酸酌丑酣酥酗配酷醋酪酵醇醉醒酝酿
酪	酷路略胳烙格洛赂酸络酥丑
钳	柑甘酣甜煤媒虚某锤错锚嵌谋芋
钾	押甲匣卖闸曼独泽浊择烛曙申薯
铅	沿锐船铭锅铝谷金麻裕错钱浴锚俗镐松
钩	拘苟狗钝钓驹够出句钧包恭袍针胞炮泡抱咆铅金
铃	伶蛉玲冷龄零令吟侈捻黔钥多今
铆	柳聊卿留溜榴瘤御刘迎抑仰贸脚孵唧馏节昂
闸	门闲间闷问闪闰开闺闽闻闭曼甲钾押匣
隘	溢益阱港陪陆锰阻赛隔陨遍温隙障际
隔	陋陌阿陨陪除险隐阻隘阳隆隙障际阴陶陷陆院降
陨	损韵圆赏员溃遗债惯价钻
雷	电蕾擂需腮霸忧青汇儒懦糯苗页而恒优扰蠕坝
电	雷蕾擂需霸忧儒懦汇页蠕糯青奄而顿颂腮烦硕
雹	苞袍胞炮泡抱咆跑包饱刨需而儒懦蠕糯
零	霉霍雨伶云霎铃玲冷灵雪霜霞蛉
靖	晴清情睛精猜蜻请青债积立端绩责音
靴	鞭革花秋靶讹鞋勒鞍批千鞠化
靶	革鞋勒鞠鞍靴秋缰千肥爬把吧鞭芭
预	顶颂烦予顽顿颁须项颇领硕顷颊频头颗类显
顽	顿烦项硕顷顶颓颂频头颗显预颁颇领须颊颈颖题类
顿	顽吨颂烦硕顷顶频颓颗显颁须项颊头颖
颁	顷频颂烦须顿硕顶颗颜显预顽项颇领颊头颓颖额题愿颠
颂	顿颁烦领硕顶顷频颗显预顽须项颊头类颠
饲	饵饱饮饼蚀饥饭饺饿肴馁
饱	饲饼饵饮饥饺饭蚀饿肴馁饰馆馅馒饶饥
饰	馁饮馆馅馒饶饥饵饼蚀肴饥
驰	驹马驮驻驶驳骇骗驼驯骆骏骑骚骡骄验骤驴驱
驮	驳骑马驶驰驻驹骇骗驼骆驯骏骡骄验驱
驯	驶驮马驰驻驹驳骇骗驼骆骑骚骡验驱
鸠	鸣鸭鹃鹊鸽鹅鹤鸯鸦鹉鸥鸳鹰
鼎	目睛眼眶眠瞒盯睦睹睬睁瞄睡困瞎盹瞧
鼓	彭吱肢枝技妓歧树厨冬澎膨支喜嬉
鼠	窜臼舅舀阎旧亡滔焰陷稻桩举芒忘妄与身馅
僧	增憎赠层曾倡醋借槽遭俗份会鹿
侥	挠浇晓烧跷绕饶佳侍
僚	嘹撩潦燎辽缭疗了佑傻倚俺布仇刹
仆	扑朴供并共借俗仅备烘哄拱洪基异恭谷
像	橡豫像你仔亿仍乞们伯他代仇杰侯侈健
侨	娇桥矫轿骄乔搞稿镐篙蒿吞添舔妖沃笑奏
兢	克克兄况祝咕嗅竞古宫税故枯胡姑沽估熄舔媳唬沉
凳	登澄橙灯瞪蹬痘岂合邓凯证盒拿丰灸久短逗
划	副刷到刑划列刊剑刽剂割剩剖刚剥刹剃削则刮制
厌	压盟痪百明奥厚焕唤懊换澳涣袄
嘀	嫡摘滴适咬商六呜咳啼嚎啃吭咙哺哨哄咱呐吐滚嘴
尝	当掌棠裳赏常党尚堂稽肖当旨膛挡敞档脂削裆铛
嗽	漱喇掀嫩吹速欣懒辣束久嵌
呕	岖枢躯驱区品噪操板欧鸥殴呢嘱咖
叹	汉摊滩瘫艰难咽哄哎嘶豆啸唯呻听吹呐吐叫
嘉	喜茄咖加台袁吉哎荔架嬉壹豆另
团	传砖转专团栽博遵府寸夺膊厨搏蔚傅等褥穗符时特
图	回占圆惦嚎哼嚷店沾点站玷帖京豪诸贴储逞高品亭亮
尘	丽鹿庇比昆屁能批洒晒
境	镜竟培垃暗亿樟忆障音焙接倍竞意章
墓	莫慕摹暮幕募昔寞葛蔓萌摸漠模膜意草音芭错惜措蟆借
垫	挚执丸孝堵墅爹轨势热痛麦究多宛夷夕丈九哮铁
墅	野序予抒多畴垫预舒豫侈型墨爹矛移埋
寿	筹涛畴铸祷云云耘坎虱至虫强蚓
梦	蔑萝还爹爵环楞移侈逻锣
夺	奋侍等时恃持集寺特对鸡封待蕉旧崔符府传诗椎进锥雄堆唯
嫡	嘀摘滴适商六妨滚嫌姆姐如交女脊奸
嫩	收嫉嗽漱橄撇撒傲喇做邀速
孵	卵铆卿柳即聊印节唧却卸刘御鲫刷迎抑仰贸留昂
寞	摸漠模膜蟆莫墓慕摹暮幕宽募昔
宁	拧泞柠狞亭密耻蜜愉愈恐十勃
寡	烦嚣硕顿颁颂频顶顷颗显颇领预顽颖项须颊头颓额题类
寥	胶谬折耀跃习翠翼翁塌嗡翰
实	惯贯赛宝圆赏贫损贝债价溃陨遗钻
寨	塞寒赛暴异共烘哄拱洪供港案基恭嘶撕溢隘
寝	庄蒋浸侵状妆壮夜候霞虾将没疫又暇殿壳假杀
察	际崇祭蒜赊棕擦综膘捺宗漂标襟
对	封寺村肘付时恃持侍等尉射特寸夺尊羔姜美守
屡	篓搂楼缕娄申坤呻匣伸神鉴甲由绅
崭	惭渐斩晰逝浙薪暂斤嘶撕芹析近听折匠
岖	呕枢躯驱区操板欧品鸥殴噪眶
币	弊别鳖毙布布敞帝帘吊厂蔽希撇怖
幕	莫墓慕摹暮募稀蔓葛昔布萌寞蒂希摸漠模膜怖布
幔	慢漫馒蔓帽幌曼帜幅帕巾幢帖
廓	郭墩廊敦店享淳爷榔椰绑惦梆挪掷娜哪
弊	别币鳖毙蔽敞厂撇敌散撒肖矢撤澈屑宵疾尚矣瘩莽销短败梢
别	弊鳖币毙敞厂蔽撇敌散仇撒肖矢撤澈削
彰	衫形彤杉影彭彩彪樟章障草音
彻	撤澈微辙霉往征徙衔徘御衍徒从徐待
愿	愿源原愁您悬白隙怕凭闷悉恳息怎泉凤惶柏迫拍泊的伯
态	熊摆能罢昆庇屁批比觅息见视
慷	糠康勾勺憾匀逮慢惦愧钓怯忱灼惨州划
慢	漫幔蔓馒曼惕悍旬曙悯惜怀慷恨甲
惯	实贯损圆溃价债陨遗钻赛积绩韵贝赏贫
惭	渐崭斩晰逝浙撕嘶斤暂析近折听薪芹匠
惨	掺渗参残惦勾勺栈钱浅廊贱践憾咸盏匀
截	雄惠崔栽虽雇专椎进锥推淮堆唯准载裁霍应奋蕉维憔
撇	厂蔽撒敞撤捎挡澈挨别弊敌散撑彻嫩傲橄做邀销梢悄
摘	滴嫡嘀适扑商挤拉拄抖六掉扯搞掠接抗撤拢
摔	蟀率掖搞拥擅掠攘抗扑撤摇掏悴挨抖粹撞碎接撵掉挤拉拄拇
撤	澈彻辙撇撒挨厂敌蔽邀敞散埃唉
搂	楼屡篓缕抽娄押申坤呻伸神拂
折	习胶耀跃谬寥塌嗡翰翼翁
摧	催携惧崔推扎摊瞧揣雏雌汇
掺	惨渗参残抬扩挨找栈钱浅廊贱践
敲	高搞稿镐蒿篙膏豪乔亭侨娇桥壕嚎停占寇
旗	于族旋旅施放其方箕期棋欺仿淤簇簸
畅	阳杨肠扬场申袒坤呻伸神伤绅汤得坦但娄
榜	膀傍磅螃谤旁楞肪方妨坊仿拢咙胧庞宠房芳笼
榕	熔溶蓉容棺欲却棕柠脚裕浴俗谷枯
荣	荧劳莹萤营莺菜采捞唠采棠睬炎肖踩
构	沟购讲耕称拼并屏阱并井
榛	桩棒秦凑揍奏矮捧痢禾禀菌苏楔播秋和私揪番泰春香委
榴	溜馏瘤留柳贸铆聊刘杉卿
槐	愧块傀鬼瑰魄魏魂柏材机几丑才么魁株板析刃魔
枪	沧抢呛苍疮舱仓梅检榆栓创食饰伶
歉	兼钦欺嫌廉欲炊坎吹歌赚软亩砍欣玖次葵疚
歌	砍吹欲证欧石钦炊玖坎次碌确款欺硝亩破砂研欣
演	滨汁凄沽沛江溶渐浙士
滚	滴六漓凉流济泣注沾淑淳液滤嫡
漓	璃凉淳液禽擒流滚滴济泣沾注溯淑
滴	摘嫡嘀适滚商济沾泣注六漓淑卤涉溢凉流
漩	游淤旋游肪妨坊仿房芳防簇旁访纺础方
漾	样泳永仪糕膳蚁议牺对咏窑漠满沟港滋泛灌
漠	摸模膜蟆寞满莫滋蒙灌墓暮摹慕
漏	雨霍雪霎云霜零震霉霞霹灵
漂	标膘蒜潭票棕捺襟崇综赊际察
汉	滩叹摊瘫艰难满洪洋冲漠港蒙涤溯
满	瞒席滞漠蒙怖布汉巾蒂英滋棉啼锦灌希
滞	满怖布棉瞒啼锦带希绵缔饰蹄忱砸巾蒂常席布
漆	膝沐渣淋黍湘沫决椎枚漱潘嗓渡澡深净浮浴栓洽汽
漱	嗽掀嫩喇速欣懒辣澄束久嵌
渐	惭崭浙斩潮晰逝撕嘶斤暂析近折听薪芹匠
涨	张长胀帐弥账浸没溺溉涎汛潜污刁
漫	慢幔蔓馒曼瀑汤渴湿混涧浊泽曙
澈	撤彻辙撇撒激厂敌蔽邀散敞挨埃唉流
漪	河逛畸椅崎倚寄奇狭凑可岳
沪	泪遍偏炸昨妒吧作窄邑
渔	鱼鲁鳖淡澜鲤涣鲸没鳍汛鳄
渗	掺惨浅参残治渡灭减栈钱洲廊贱践滋
涤	条附沧沦海洽汽袱咐滩汉淮休仲除悠茶
卤	卤咸碱济注泣沾浅滴涉渗滋滤流淑溅盐
熔	榕溶蓉容欲却脚裕浴俗谷豁穴综绽驼鸵缩缤烤
熙	炎毯照巷杰灰癌局包峭炮加
熊	态摆能罢昆庇屁批比觅见视
熄	媳息嗅钻虎少沉炸炒臭煌唬烙兄鼻赞忌
荧	荣劳莹萤营莺痰炎捞唠燃淡
尔	弥弥燃杯肖不尽劳捞唠销然敞硝尽梢消捎悄峭屑宵哨
狱	岳辩罚蔼诚咏诫试诀讨计讼讹谜谢训诵诬详话询
琐	锁珊斑班瑰理现玷玩玫玖王
玛	码妈吗蚂冯闯骂驾马惊驻驶驹驰驮驳
瑰	块珠班王槐愧傀斑魂魄琅球理现丑玷玻珊玫玖
疑	拟凝碍丸爹执比夭夕匕痛多雄沃妖此外
疟	据庐芦些虚虐唬滤炉
疯	枫飒讽飘风疫台刮咒冗疼肌处凰佩几殿跺躲壳凯杀殷
痪	焕涣换唤勇踊希疚懈奥痛厌夷友九澳懊琼袄
尽	尽杯仑盔盖盏瘟篇卢蓝盆篮贵蝙盅皿册磕温溢遍隘
监	蓝篮滥舰盅扁忍盏盟盔盛益盈杯孟盐盖皿册栅
瞄	瞒蒙目算描瞳锚困睬猫睛睦睁瞎瞪瞧眨睡眼
睡	捶唾锤垂邮盯睹眼盹盼瞄眨目
磁	滋慈砾碾碘碰碟砖硫研石
碟	谍蝶叶砾碾石磁碳磕砖硫礁矿碘碰朱研泵
碧	磨皇拓司答言筒石瑰煌惶泵凰合歌铜碉硼蝗硝减
碳	硫砰礁砌石碟碾碗灭矿砾硝砂研禁御票祭祟炭
硕	头烦顿颂顽频项顷颗顶额显颁颊须题愿颠颤嚣
福	逼蝠幅辐富祸挡当档裆铛祠礼祷神祝祖祈社
祸	过涡锅蜗窝祖福视猾滑祠祝社
种	肿董冲重动懂秩稚秘科稍租秤秋和私程秒禾番
称	稠稻稳租构程禾稿沟秆稀穗秽秒稚稍秧秋和私番香委
洼	涯窒空窑窖穷窃窄突帘究窝窟窘崖浇
窝	锅过涡窘窖祸蜗窑窟空帘窜窒窄突究洼窃猾滑
竭	遏葛褐渴揭喝谒意音暗章亿忆竟
端	揣喘瑞而耍耐靖立音竭竣站飒意童章竟
管	棺官馆刮舌活括恬甜篙宫阔古千舔
箕	簸棋其期旗欺甚具甘堪俱
算	篡省眉瞄瞒看冒箱自目楣媚相蒙眷盲首咱
筝	狰净挣睁争静筋筒算篡荣等菜受奥竹自血凸胀朋向
粹	碎悴醉翠料粒糙卒伞米精糕糟粮粉粗籽糊
精	晴清情睛靖猜蜻请积青债糊绩米
绽	综锭缤缩绒丝绪绢缔纬缓结给提堤
综	绽棕缤缩崇丝蒜绒绪纬缓经绢
绰	丝绞纺纹统细掉悼纤织维绪绊组绣纱纯纽纳纪
绿	丝录缘碌纠氯组细纽维缅绊缕纹纯级纳
紧	肾坚贤竖丝紊系紫絮繁累索素系罗哟蕴辫
缀	桑丝络终级纽绽综绵绢纬编线缓缔
网	纲绸丝组缓绢细纹纳纠纤
纲	网绸钢丝缓组绢细纳纯纪岗
绸	纲网周丝缓稠碉组绢结
绵	线棉锦缔帮编丝绢络终总纸缴
维	丝纳细纽罗绊组绣纱纹纯约纪纠结给绘
绪	丝细堵纹缩绰维睹诸绞绊组纯纽纳纱绣纪
罚	蔼狱罩训辩罪罗置买众志诫详询谈课谁诽谓注咏
翠	翼习翁碎醉塌悴寥粹折胶嗡
闻	闯门闲间闷问茸闪聂闺闸闰开闭耳
聚	骤众医伞汇纵踪从耸尿卒来巫夹坐涤俭淮侠
腐	肉府俯瘸付符咐附专寺守内寸钠侍肘村呐
膀	榜傍磅螃谤旁肪胧楞方妨坊仿拢咙庞宠芳房笼
膏	高豪亭毫蒿篙乔京搞镐烹亮享赏稿嚎
膊	搏博傅缚脯补铺浦捕哺圃肘将辅甫
腿	褪退堰银眼根恨痕跟脐狠限腋丹胧髓艰很肪良
台	台吉喜袁嘉肚豪高亭售告周碉捐
与	举誉屿臼六舀身交滚滔鼠焰兴舆商儿滴摘嫡嘀舅
舔	添舌甜刮恬活括笑侨娇桥轿沃妖阔奏
舞	侈多爹移宛无麦夕铭杰挚茅名令麸抚外
蓉	熔榕溶容欲却脚谷裕浴俗苦荸蘑穴葫豁
蒿	篙搞镐稿高侨娇桥矫膏轿骄蓄豪亭敲壕嚎停
蓄	畜荒芒玄炫弦蒿药莲慈慌舷蒂菩芦荠蓬茫
蒙	朦蒙檬菜蒙荤前且莹煎壹剪蘸同筒巫丙铜桐洞
蒲	薄浦甫簿补铺脯捕圃哺萍葡荡茫范藻膊辅搏博傅
蒜	斋崇综漂膘标棕捺察赊际襟
盖	磕蓝盏篮滥监尽篇瘟卢盆仑溢法怯
蒸	拯煎蕉芜燕淡葵庶蘸苏永葬蔗痰氮兰茅漾
苍	疮枪沧抢呛仓舱茶养食荷创
蜜	虫密萤强虫搔骚闽蚤蛔蛙蛀蛆蚯蛇蚊蚓蚪蚌蚣
蜻	虫晴清情精靖睛猜蚌蝴虫蝠蜗请螟蛤蚣蛆蚯
蜘	虫蚯蜗蛤虫蝴蚓蛔蚊蛉蜓虾蛙蛀蛆蚪蚌蝇蜈
蚀	虫饵饼饲饿饮饥饺饱肴饭饰馁
裳	当棠掌尝常党尚赏堂衣依裁肖当袁制装袋袭膛敞挡档
褂	挂卦街畦桂挂娃佳鞋蛙闺封涯崖
裹	衰果裸棵课巢还禀萎回困
裸	棵果里袖裹课由巢困栗油抽栗捆申笛
制	裂裁依装袋袭衣裳制前箭
诵	通讯详诅桶讨订计诬诚话询课谁蛹注咏
志	诗认读诫谈试谍谓讼谊谅请谋诺谒讲
语	梧晤捂悟误讳谋谭诬评讶订
诬	订谁评诅讶许计课详询注词诈诉诀记讨
认	志诫试讼记诗谈谍谓谬识询词诈讨计
诫	试诺讼志认诗谈谍谓谋谎谱识诚咏
誓	誉哲这譬警唁信言谅谜逝折谆浙计让
误	娱语蜈设志认诫试诗诡谊谅谈谆请讳谋
说	锐诈脱记悦计讼诬该详诚话询课谁蜕注咏评词
诲	论诊侮讹梅晦海悔识诫谓讼谁许
诱	透诈设志认诫诗诡谈诊谋谍谓讼
豪	高亭膏嚎毫壕京亮享烹蒿篙搞逞停镐
貌	藐捣笆皂脾脉肥白巴皆迫柏爬泊拍怕帕把吧伯腺楷绝揩
宾	滨缤鬓富宣宗完宇士汤寡容家室定穴
赊	际败蒜察贝贼赋贱膘贮贬棕捺崇综漂赂赔赐标购
赫	吓赤赦倒斗小测喇涮侧咧例亦闹厕前
赵	趟赴走越起俏赶超趣趁趋销梢陡消捎悄峭哨
赶	焊杆捍悍秆走赴超赵越起趣趁趋趟旱但干陡
辅	轰铺补脯轩浦捕哺轧博车圃轴软轨
轻	经径茎氢轰辐轩辆车轮辑输辖辕转轧
挽	晚挽娩轰冕软逸冤轧轨车轴轩免兔
辣	辨辛办瓣辫辩锌速宰辟辞滓辜僻避薛
远	猿辕园哀袁逞造迎褒衷嬉结台周禀周吉
逊	孙孤吼系县孔系孩迎洁悬玄
遣	遗逃止溃尽啃扯址啡步正肯企逼过蜗这逗造涉歧怔跳
遥	摇谣淘掏陶萄运缺缸坛敌离罐周
递	彪虎唬号密造彤遍逸透逢边追秘迫返近必
鄙	部啊郑郭都郊郎郁邦那邢
酵	醇酷酪醉醋酥酗酸醒酝酿酣丑配酌
酸	梭峻唆俊竣骏酪酬酷醋酵醇醉醒酝酿酣酥酗丑
酷	酪酥丑醋酵酸醇醉醒酝酿酣酗配酌
银	退根恨痕眼限狠跟艰很腿褪堰良宴
铜	桐洞筒钢硼同石壹碉喊洽拾恰哈锄答言
铭	名移侈爹多夕铅麦宛铃锅胎治抬始外舞
衔	术街衍衙卫冲衡行御彻微征徘徙徊律很往征彼得径徐役
铣	洗先锐窖锤钻岔锥钞钮钝任锦镜铆
闺	门闰闲间闷问闪闻闸开闭畦桂挂娃佳
闽	虫蛋蚤蟹虫蚀融强闸闰开闲间闷问闪蛮门蛙蛔
阁	客路略胳烙格洛赂络各酪骆搁
阀	闪合门筏闲间闷问阔闺闽闻闸闰开闭欠关们伐
合	答闪阀洽拾恰哈蛤给签问门俭
隙	原阶陷限陌障际隘隔陨险阳隆陪陵陆陶除院陋降
障	樟陪章暗隧亿忆境镜防草音响
际	察赊蒜祭膘棕捺襟综漂标阻崇
雌	此批北比齿能昆庇屁摧催上
需	儒懦糯蠕雷电霸而耍忧恒蕾瑞擂揣喘耐
颇	类烦频顶顷颗皮领硕顽顿颁颂预项须颊头颓颖额愿顾显
领	岭颂烦顶颇硕预顽顿颁项须颊频头顷颗题类顾显
飒	枫讽疯飘风刮台佩凯肌竣立音冗
台	刮风枫疯胎治抬始冶飒讽
饺	饼饵饭肴饮饥蚀饲饱饿馁
饼	饵饮饥饺蚀饿饱饲肴饭馁饰馅
饵	饲饼饮饥饺蚀饿饱肴饭馁饰馆馅
驳	驮骑马驼骆驰驶驹驻骏骚骡骄验骤驴驯
肮	髓炕杭抗坑吭航脏体
魁	蚪鬼科抖料斗斟斜槐愧块傀瑰魄几么
魂	几瑰槐愧块傀丑魄魏叽机云讥鬼魔
鸣	鸽鹃鸥鸠鸭鹅鹊鹤鸦鸯鹰
凤	凰风鸟几鸣鸠鸿朵鸭鸽鹃鹅鹉鹊鹏
么	摩磨糜魔靡蘑麻玄畜药术烁似吆
鼻	息臭赞画虎斤熄划媳嗅唬沉哲畏芹斧兄工困晰斯喂
齐	剂济挤荠脐斋卜肃臼立占主斗文六丹亡下上朴扑仆
亿	忆倍位暗意樟境障镜音竭章
仪	蚁议义俄我牺样漾糕膳饿蛾对鹅件窑
僻	避霹辟办辩辨瓣辫薛滓辛壁臂辜锌劈宰
僵	疆缰仁会儡合俭偷偎伦盒拿仑命
价	贾迁债栗腰溃惯遗陨积损绩韵钻实圆栗
俭	捡检脸险签验碱偷伦哈恰拾洽伤侮伶答合
凛	禀冶凌冻回冰冷准次冯凝匀稿醇坛擅檀翠
剧	刻据剑刽剂创剩割副剔剥剖刹剃削克刷刺制
劈	壁臂璧譬辟僻避分叨辜券霹初
刘	刹铆聊则柳刷划剂剩剔剃削克刻刺刮制别删利判刑
剑	敛剧副刻刑刊刽划剂割创剩剖候刹削刺到刮制利刨删别判
刽	副刑刊会剑划剂创剩刹削刺到制判利删列划
厉	万励迈席薯愚寓藕满瞒遇偶袜
唠	捞劳荣荧肋咖燃唤莹萤营筋勇另
嘹	撩潦僚燎辽缭疗了刹咖另唱哎显
嘲	潮庙朝惭渐崭干哺味咕吱硼斩肺喷嗜嗦干韩
嘿	哩黑墨里埋里理狸童默点鲤
嘴	角柴些唤唁触紫啃吭嚎啼唬嚷哼嘀台
哗	桦华哎咽苏荆横唾甜哄葬豆
喷	坟愤员损喧贮贝圆赛贼陨宽赏实贯
嘶	撕斯哄晰逝浙听惭渐斤崭薪芹析近折斧匠
啸	锈肃萧箫绣吊呻渊姊吐叫口品亮叹哑唯哨哩咽咪哄
叽	机讥饥几吆砾烁后魂哟玄拗似鬼药关畜巍
增	憎僧赠层曾醋槽遭坛鹿糟坦晒西曹错烟场堤唱倡
坟	喷愤贮贝赛贼宽实贯员瞎贱惯损填贿贴败狈财盼则贞负页
坠	队逐阳堕猪据场陌垦剧缘畅杨肠
堕	椭随坠塑陕肚周史陆陌阻压雷电病肯左台蕾角郑擂
墩	敦廓郭埃教枚撒嫩撇撤橄澈傲邀做淳唉享
嬉	喜结嘉远台鼓娃周吉膳猿辕彭培始树
娇	侨桥矫轿骄妖乔稿搞镐篙蒿吞添舔沃笑奏
宽	寞觅见能它坟喷愤砚视现规比
审	播潘番婶沈秋萎禾秦锹揪
写	泻牢宅臼插舀审宫宵宋安它穴客身十滔焰
层	增憎僧曾赠匹鹿醋曹西槽遭晒鲁医晶尸糟钾
履	复屉薇症纵复踪从徐御很微得徙徒律徊衍往
幢	撞瞳钟童帜帖霎暗幅焙接培陪倍巾
帜	职织识帖幢帽幔幌巾幅硫梳琉流帕帆
废	拨泼发壳葵疫饮股投疚谷歌毁殿钦杀殷亩般段砍炊
厨	树府橱澎膨蔚符等鼓时恃持咐侍冠夺团遵传彭蹲特
庙	嘲潮朝崭惭渐麻库甫干霸蝴干韩斩脯肺
广	扩旷庶度戒矿席廉甘械蔗盏黄蘸芋其兵西醋横
厂	蔽撇敞弊别撒撤澈矣敌散挨埃唉币屑宵鳖销彻辙梢
弹	阐蝉单战愕器囊板嚣
影	衫彤杉彰彭彩彪形晾景掠凉吵京
德	听从得徐待役行徊律复径后循徙徒很往征彼征冲衔
征	症微霉往彻街徒律徊很待薇惩冲衡衔徘御术衍循彼复
庆	反忧处优扰略板返扳各冬皮及锋殿赂酪络菱
慧	丰叼虐刁扫浸侵伺邦雪妇帚归梆蚌长锋绑峰
虑	肤卢滤虏甸庐芦虚思虐虎腮炉葱疟处
慕	莫摹暮墓幕募昔葛蔓寞萌模膜摸漠意草音芭错蟆惜措借
忧	优扰厦菱处反凌各冬傻陵胳后板返扳
慰	尉蔚屎忍惠悉糖糠凭愚米寸感急怎忌寺守怜穗迷恃
怜	磷鳞粥邻杰籽迷咪粱屎
悯	润涧们搁拦澜栏烂门文闷简
憎	增僧赠层曾醋惜槽遭鹿糟悍晒西曹旬
愤	坟喷惯惋贮贝赛贼惧宽实贯货员瞎贱损慎贿贴败狈
憔	瞧礁蕉焦惧锥椎进推淮堆唯崔
摩	磨么糜魔靡蘑麻术述举空穴控挖
挚	垫执丸孝舞痛爹堵轨热势麦究多宛夷夕丈九麸杰哮
摹	莫慕暮墓幕募昔蔓寞葛萌模膜摸漠意草音芭错蟆措惜借
撞	钟幢瞳接童拉啦樟亿忆暗焙培陪倍泣垃位
扑	朴仆拱撕拼共撰描措烘洪哄供摸搓搭撒摊基异恭
捞	唠劳荣荧肋燃换莹萤营筋勇挡捎撇抛拗尔莺
撑	挡捎撇膛当档偿裆铛呀牙掌棠尚
撰	选巷拱损起哄撕共戴粪捐扑烘洪抱供扣冀基异恭
拨	泼废发投壳股搬疫澄谷橙灯搁毁殿瞪殷般段役歌钦亩
挠	浇晓烧侥绕跷饶挂挂持
撕	嘶斯逝浙拱晰折惭渐掀斤崭薪芹析近听斧匠
撩	潦嘹燎僚辽缭疗了捺捧揍掩刹措捏挟显抛春奉
撒	撇散撤蔽澈挨厂敌敞彻橄嫩傲邀做
撮	最娶扬捍捏提揭取揖技摄措把趣丛耳支
播	潘揪审番禾秦矮透锹萎
抚	芜无抡拴拾拖推扶夫舞庶捡擒抢撵舍捻挫揪
撬	耗尾毛毡毯拙扎摧掘携牲
敌	敞散离献枚数敬敦敢败启敏效故政放牧玫改收撒撇撤澈矢
敷	放邀族救激窍敌数敬敞敦敢散教败启敏效政故致枚牧
数	枚收敌敬敞敢散启赦政故牧玫攻改矢疾矣
暮	摹慕墓幕募昔蔓寞葛萌模膜摸漠薯着
暂	斩崭惭渐斤芹晰析近折听匠斧斯逝浙祈欣所
暴	瀑爆洪寨塞寒异共港烘拱哄供赛溢
样	漾糕永泳仪膳蚁议牺对咏窑槽模构权义善羔姜美
樟	障章暗亿忆粒境镜草音
桩	榛棒凑揍稻秦奏滔焰捧陷馅蹈臼阎旧
枢	岖呕躯驱区操板框柜欧品鸥殴噪
标	膘漂棕蒜票捺襟崇综赊际察
槽	糟遭曹曲浓遵脓模礼蹲体
模	膜漠摸蟆寞莫横桦檬权暮摹慕墓槽错措惜借幕募借昔
楼	搂屡篓缕娄申坤呻伸栖梗神
樊	攀稀矾希疲肴驳椅决快尖艾筷疗爽缺
桨	浆奖酱蒋将肘乐采床梁栽辱森厢药寸膝缚膊搏琳博傅烁林村
乐	药烁床砾以幻几梁栽玄吆幼畜机炫弦似
欧	鸥殴吹歌砍欲区钦亩欢炊玖坎次歉歇款欺饮软欣证枢岖呕
毅	谷殿毁壳设殷般段股投役殴杀疫跺没浸侵逐佩夜
殴	殿设殷股投谷毁壳般段役毅杀疫欧鸥咒
浆	桨奖酱蒋将肘辱薄簿寸缚膊搏博傅雷电尊专泵采汞寺守符府蕾等
澄	灯橙瞪证蹬登泼壹礼洽体凳邓葵
泼	拨废发澄壳没股投淀疫谷灯橙毁殿瞪殷般段役歌钦亩
潦	撩嘹燎僚辽缭疗了源滞淹汰刹湿淡沿淆显
洁	骡嗦螺丝系细累素线绢结绒绝绍纷维绣
浇	挠烧晓侥绕跷饶涛涯洼法翘
潭	坛谭漂樟标膘障早
潜	既溉蚕概慨潭涧污浓涯源汪汗污
潮	嘲渐庙朝湖惭沛汁溯崭干浦沽渤凄斩肺滓滑泞
澎	膨彭彬树趁珍疹穆谚诊厨鼓形须衫杉须派法影彰彩浩彤喜
溃	遗贵债积贡损绩陨价惯钻圆
润	涧闰澜煌惶汪斑班开悯栓拴们
涧	润澜简间们门悯拦烂栏湿搁汤晚闷闲问冕闪
潘	播审番沈禾溜矮透锹揪萎秦
熟	热享敦淳郭廓丸墩烹爹谆醇
熬	赘傲煞灰然痰邀放矢尺焦无黑疾羔炎灸矣燃埃恢
热	艺熟势丸执爹挚垫痛灰多夷夕九封
奖	浆桨酱臭哭突将献状吠伏蒋莽默肘器犬栈兽
莹	荧荣萤劳营莺玉璧捞唠蒙琅球班祖
璃	漓琉斑玷班王瑞珊
瘩	搭塔答痒合荷鸽洽拾恰哈合痘痊拿
瘟	温酝卢仑篇尽盖盏蓝篮盆盗偏蕴皿册锰滥溢遍
瘤	榴溜馏留贸铆柳聊刘奋卿疼疫奄疯
瘦	搜嫂艘桩痢臼舀布疼疫疯逮
疮	苍枪沧抢呛仓舱餐痊疹痒疙食创夺
皱	被波披坡跛雏破玻彼疲皮菠颇簸
盘	盈般搬监盟荡盗盛盔益杯盅扁孟疫殷段股投
瞎	辖睛害睹瞄睬瞪瞻盯目瞒睦睁瞳瞬瞧蒙眨睡
磅	谤膀榜傍螃旁咙楞肪啼硫方
确	礁歌碘硝砍碉石硕碰碑砚朱砰砂研呐硼砸
碾	砸展磁碟砾码石磕碳礁硫矿碰碘研泵
磕	盖滥盏蓝篮碾蝙碟礁硫砾矿舰
码	吗玛蚂妈冯驾闯骂惊马驻驶驹驮驰驳
稿	搞镐篙蒿娇桥侨矫轿秽骄科高稻称程秒稍租和稠禾
稼	嫁家家穗秆秽秒稚租科禾黍稿稻称积程稀棕移获稳
谷	壳般殷段股投毁殿役毅殴设杀疫没躲浸侵板坡肌搬锻枫皮
稽	就私尝穆尤稻穗秽秆程稀移秒禾香
稻	滔称蹈稳稠租舀桩程秽秒禾稿穗秆稀焰陷稍秧秩秘秋和私番
窑	糕羔窖羹窝窟窘窒空洼窜窄突帘究窃膳
穷	躬窜窄身窃窖窍窗究躲洼窥突空帘躺
箭	煎剪前制削刺制莉荆斗涮刷宽算蒂菜箕荐痢升
箱	厢湘霜相策算目楣想篡媚省眉看冒自亲睬困帽租
范	轰库军连载阵车轧辈莲范荤晕裤辑运浑轴挥软链
篇	遍偏编蝙扁篮盛肩匾蓝盆瘟尽卢盖盏仑滥炸昨妒作
糊	湖蝴葫枯胡精米胡糙做糖粗料沽姑咕估苦居固
缔	啼绵蹄蒂纤织丝纹绢绷绰绞统纺帝
练	炼丝细拣绊纱维绣绅组纹纯纽纳纪约纠纬
纬	违伟韩苇围丝绢结给练缓绽综缩纤绒
致	缴丝致缅红绑倒维绪绞组细纹纽纳纫
缅	丝面红细绣绅组纹纠练绰绿维缕绞
编	遍偏蝙篇线绵丝绢总络终纺纸扁
缘	丝绿纠维组纱纽纳纫纪绍纷练缅绰绪缕绞
线	绵腺丝编络终纸缴绢总织结绒绝绍纷细纱
缎	锻搬淀丝段发纵缴纸线络终绑缝绪纱纹纽级编
缓	暖援组纲绸绢丝网纬编线缔绽绵综
骂	闯妈吗驾惊码蚂玛冯马驮罩置买众驻驶驹驳驰驯
罢	摆鹿棍混能熊态皆楷阶揩
翩	翔翻翅扇翘翎羽匾塌习翁
膛	堂挡当档裆铛尚偿当棠掌撑销梢消捎悄峭哨俏常党
膜	模漠摸蟆寞莫朦暮摹慕墓错措惜借脏幕募昔
膝	漆采黍采肘菜膊睬椎枚荣踩腺栓林朋来月桨爱森受
胶	谬寥折耀跃习翰塌嗡翠翼翁
肤	卢虑庐芦虏炉滤虚胃虐虎甸驴
膘	标漂蒜票棕捺赊际襟察崇
蔗	遮庶苔莽戒芜械度荐茂广盏席芝诫镀渡
蔽	厂撇敞弊撒别散敌澈撤币屑宵鳖销梢消捎悄峭哨俏
蔚	尉慰厨符府遵冠屎夺等团寸褥树传特时持恃附
莲	轰链荤运连晕裤浑挥车撵库军辉轧辈载轴软轩阵轨
蔬	疏菲止蒋萨庄肯企岁遣遗硫逃琉梳流扯址
蔓	漫慢幔馒曼幕莫暮摹慕墓葛募昔萌
蔑	梦萝箩还楞爵环袜逻锣
蒋	庄将寝状妆壮薄浆桨奖墙肘蔚菲酱菜
卜	苟芯富逼苞芍福幅副葡菊苇石蝠辐茵茴苛苦若苗泵芋瘩
蓬	篷逢返莲冬炕杭抗坑吭落菠芳菱反
葱	聪惹思虑慈萎腮蕊董芯芹懂
蝴	虫湖糊蜻蛇虫蜘蚓蛔蛆蚌蚪葫虾蝌蛙蛛蛀蚯蝇蚊
蝶	虫碟虫谍蟆蚣叶蝠蜗蝙蜻蟋蛤蛇蚁蛙蛛蛆
蝠	虫福逼幅蛤虹虫蜗蜻辐蝉蚣蠕蛔蛆蚯蚜富
虾	暇假虫蜓蜈霞蚓蝇蚊虫蝴蝌蜘蛔蛀蚪蜂蝉
蜗	虫祸过锅涡螟蛆蜘虫蝠蜻蜈蛤蚣蛔
蝙	遍偏编篇虫蝗螃蜂蟋蛾蛛虫盛扁
蝗	煌惶虫凰蝙蜂蟋蛾蛛虫皇
蝌	虫蚪蛛蛾科蟋虫蝴虾蜓蚓蛀蚊蚌蝙蝗蜂
卫	衔衙衍冲衡街术行彼征彻微徘御很徊律往征径徐待
冲	街衔衍卫衡衙术种肿董循行征役
褐	遏渴揭喝竭葛谒袒歇锡惕蔼
复	腹复被袱反返板扳候夜各冬
褒	衷袁堡哀旅迎远保卒途躁仰裹享昂夜衣逊进起依迄抑
谊	计诅谓谈请诫志谋试讼许讯订
谅	谆让谜谈识注谴志诫谚诺谓谤讼该访
谈	谅诫志谓讼谊请认谋谍诺试诗谱识
谆	谅让谜识淳醇注访谴谊谈请志语认诫误
诞	涎设讯谜讹误诡诽谢训谴课谁诵诬详诚话询
请	谓谊谈论志诫谋试谣讼详诅谨计订调
诸	储堵睹着暑屠奢赌绪署猪者煮
课	谓谁询详注诅诈许诀讨讯记计订
调	碉谣诅谓谁注计请志周课详话询词诈
谁	许课诬详询注诅诈诀讨讯记计订讹
论	诲诊伦讹沦抡请轮诫谓谁许谊谅谈志语认
诽	啡排徘匪菲罪靡训谜谴诞谢讹课谁诬详询
豌	碗腕惋婉头宛壹澄灯橙瞪礼蹬体
竖	肾坚贤紧痘登丰岂短逗凳臣宦临卧服藏盒豆合报
猪	堵屠诸睹逐着暑奢赌绪署
赔	赂焙培倍贴陪贝贱贼菩赋购贮赠赡贿赚败财则
赏	圆陨损当棠掌常韵尝党员尚偿裳实赛贫
赋	武赔赊贮贝贱赐贼赂购贬赠赡赃赎账贴则
贱	贼钱贝溅赔贮贬赠赃贿贴败财则赐赊购赂栈浅赎账赌赚贩
账	胀张帐贝贿贴败财赌赚贩贱贼贮则
赌	睹贿败堵贮贝诸贴贩财贼着暑屠奢
贤	肾坚紧竖赘费贵买贸质资赁贾贺贷贯货赞责贡员厕测侧狈
卖	钾曼甲押匣薯闸牍触续赎读
赐	锡惕踢赠贝贱赂贼贬财易赔赋赊购贮赡赎赌贿贴贩败则
质	贸买贡贾费贵责赞贤资赁贺贷贯货员狈
趟	赵倘淌起赴走越躺超赶趣趋趁陡徒俏尚
趣	超走赴赵越起赶趟取趋趁聂陡椰徒摄闻茸
践	踱足踩踏跋蹂蹈跺蹦蹲躁跟距趴
踢	锡惕赐蹋踏跟足践踩蹂跺蹈趴易踱踊蹄跨跪蹦
踏	足践踢踩踱跟蹂蹈跺蹦躁距趴
踩	蹈蹂跺足踏践蹦躁蹄踱踊蹲跟距趴
躺	淌躬倘身趟躲躯穷尚儿当棠掌堂膛挡当档裆铛常党
辉	运浑挥轰荤晕光裤军撵链莲耀车连恍轧晃库
辆	俩轰轩轴软轧辐车辅轨轻两挽较轮输辖辙
辈	悲轰连库军靠载阵莲范链非菲车排啡匪
轮	输伦沦抡轰论车辐辖软轩轧轻辑辕辙转轿辆辅
适	滴摘嫡嘀商六这述迟滚交卜游脊
遮	蔗弃庶械戒踱诫镀渡扩旷矿述率度充
遭	槽遵糟曹曲浓迈脓暗蹲礼体童音
迁	腰栗价贾粟栗要千复袖逼还这逗近亚奄
邻	那怜郎邦磷鳞邓郑鄙郭都部郁郊
郑	掷郊郁邢邮部都郎邦那邓鄙郭
邓	邢登澄灯橙郑瞪蹬凳邻鄙邮部都郭郊
醇	酿醉淳谆酵醋酷酪酥酸醒酝丑酣酗配酌
醉	醇酿碎悴粹醋酵酷酝酸醒酪丑酥酣酗酌
醋	酣醒酷酝丑酥酗配酌醇醉酵酸酪酿
锌	辟辞宰辜辛辨办辣滓瓣辫辩钟僻避薛
销	铛梢消捎悄峭哨俏锁肖屑宵稍硝赵钞尚
铺	补脯浦捕哺圃辅膊搏博傅甫缚蒲
铐	烤拷考针镇锭丈赌钙杖仗铁锌铺锯
锄	助抛拗沮姐功胜铜筋劳胁宜渤勤蛆组粗租祖阻
铝	侣宫吕锐营铅兑呜脱悦税沿锤阅
锐	脱悦蜕税说阅兑铅铝兄况铣祝嗅克钻岔
锉	挫雁座坐锥钠难滩摊谷瘫进椎淮推堆唯催集焦崔售
锋	峰蜂降赂逢贩略胳烙格洛返板扳
阅	锐税脱悦蜕兑说闭问闺闻闸板闰开闲间闷闪门
震	云雪晨雨霍振霜霎雳
霉	零霍雨侮霎云梅晦海悔灵雪霜霞诲
靠	悲辈告啡非菲诽排徘匪罪造浩
鞍	革鞋靶勒缰鞠靴秋按鞭千霸
鞋	革靶勒鞠鞍靴秋缰蛙畦桂挂娃佳鞭千
巩	恐筑霸筑革鞋鞍靴靶鞠秋勒缰
刮	台活括恬话风飒枫舌疯阔甜舔刮讽飘
养	食痒浪娘琅狼良餐苍仓疮馁枪艰沧抢呛
饿	饥饭饼饵蚀饮饺肴饱饲馁馅饥
馁	饰馅饥饼饵肴饮饥馆馒饶饿饺蚀饲饱饭
驼	驳驮马骆骏骑骡骄验驶驹驻驰鸵骚骤驴骇
驻	马驶驹骇驰驮驳驴骗驼驯骆骏骑骚骡骄验骤驱
驶	驮马驻驹驰驯驳骇骗驼骆骑骏骚骡骄验骤驴驱
驾	吗码闯妈骂惊玛冯蚂架马驮贺驻驶驹驳驰
驹	驰马驻驶驮驳骇骗驼骆骑验驯驱骏骚骡骄骤驴
发	松胡须鬓拔跋衫杉岁疹匆犬澎影膨穆彰
闹	柿市斗痢莉荆前巾喇捌俐制裂帝吊布罚厕蒂测啼
魄	白槐愧块傀的瑰魏鬼泉皂魂丑几皇
鲁	鱼渔鳍鳖鲫鲤鲸鳄
鸦	鸣牙鸭鸠鸽鹃鹅雅鹊鹤邪鹉鸥鸯鹰
麸	面麦扶芙干撵杰侈夫舞窥替规承夕挚宛多令
黎	黍秩八答签历筏禾才种豺番香委秀符稻潘穆漆稚雅秽程沥秘
墨	黑里嘿埋灶默点里野哩量垒童焦羔黔鲤畦理
齿	此雌出上龄逃兆桃挑姚
儒	懦糯蠕需优擂偷伦坝蕾扰而愈仑
尽	尽杯遣遗溃伦跳仑偏俏啡排桃逃姚挑匪菲盔
冀	戴粪背翼异共选撰卢虑暴肤寨塞寒基恭益巷港烘哄拱
凝	拟碍疑次冻准冰凌冷冶冯凛雌此北丸爹匀
剂	齐划剩剖刹削刻刺制判删利刑刊剑刽划割创副剔刚
当	挡档裆铛哨当党膛硝尚掌棠偿福幅堂常
噩	丧王吉鳄玷旺枉弄汪全再玉器瑰碉喜单斑
吨	顿倾濒贰岭苹吁颓硕烦顽顷页须
噪	澡燥躁品区操呕呆保藻喳嚷咖枢岖癌板棠
器	哭嚣严区兽吠单咒莽临阐囊臭突弹蝉献伏
壁	臂劈璧譬辟僻避霹辜薛辛宰锌
垦	恳猫豹豺狠坠貌解堰痕泉皆皇召分履藐凰白
坛	擅檀坏壕壤坑坦毡增场堤颤璃境培垃卦址
奋	夺鸡蕉崔锥椎进雄堆唯推淮旧截雇瘫憔离杂稚
学	觉季孝存搅李字孕浮俘肴荸脖籽好仔
导	道尊寺守肘专辱首对射村付冠自尉讨封耐
宪	害患毒精睛靖晴情清猜青厅积绩请蜻债听
凭	马驹驰蚂闯码驶驻玛驳妈吗驮冯骂驾驼驯腾
惫	佣用内钠呐应想您思忠芯志肉甩丙掏拘
忆	亿意暗樟境障镜音竭章
憾	撼感怠勾勺惦惑匀惨慷惹恕台恰恃心句
懊	澳袄奥恤筋向焕换涣唤愧怕制必痪
懈	解蟹焕换涣唤痪踊勇性琼尾懒怪牛刀忿
战	单弹蝉阐兽团辅当裤器哭哩咽找伐挡档践福
擅	坛檀拥摔搞攘掖掠抗扑毡撞提扬捍颤
拥	攘抗擅摔搞掠掖扑亥撞接拄挺
挡	当档裆铛撑捎撇当膛党掌尚偿福幅棠堂
撼	憾感抬怠找拭挨搪惑台扩掺搏捕拔惹恕
据	逐剧猪疟扬滤唬
择	泽绎译释押摆幸浊曙烛钾卖闸曼匣
擂	蕾扰雷电儒懦糯蠕青播优描揣晴抡情清坝
操	板枢噪岖呕采躯驱区品澡燥揉攘捐保扣
捡	俭检脸险验签拾碱舍拴抡恰洽哈搭抢答擒给蛤捻拖钥合合
擒	禽抡捡抢舍捻拾拴拖漓璃抚于推扶仆
担	胆瞻赡拾拯拓小捡搭逼换揉逗捂
整	症歪怔征正政嫩企止武肯遣趾扯址收
历	历沥香雳秆黎汤秩季查禾才穆种酥杆秘豺秒
晓	烧挠浇侥绕跷饶时捏翘畦桂挂娃卦佳闺
昙	云师震雨雪筛狮佩霎霉零雳霍云霜帜漏
朴	扑仆柑共棋烘洪拱哄林供横槽模檬榕寨异基恭
桦	哗华横檬柑模权棋荆构槽械葬
橙	灯澄瞪证蹬登壹礼体凳邓葵
横	桦黄檬柑模权棋标槽哗构械朴广
橘	茅矛雾务移桶多侈楣棚予爹橙样猾揉桅抒榔
树	厨橱膨澎咐鼓村时持恃侍等谢附遵蹲彭特蔚夺符府
橄	敢杆嫩做枚撒邀撇傲肝汗奸杆竿旱
椭	随堕椰榔梆郭啊郑陕郁郎邢邦那
橡	像豫象桶李椎根柏枚林橙桅
桥	娇侨矫轿骄乔稿镐搞篙蒿吞添舔沃妖笑奏
机	叽讥饥几烁砾槐后魂吆药巍玄魏拗似鬼乐关畜
历	沥历雳武企扯址啃趾止肯岁赋歧正症歪步秽遣徙政科怔征
淀	锻搬殿缎发臀杀殷股没投疫泼壳般段
澡	噪燥躁藻品保呆操灌涡浩沼治沿况癌棠区
浓	脓农槽遭礼体污遵糟漂甚
泽	择绎译释浊幸曼烛曙钾押卖闸匣
浊	烛独触蜀泽曼择曙钾押卖闸匣
澳	懊袄奥涣沃添筋向潘焕换唤泪浩洛泊制痪
激	缴窍邀放族澈淤傲敷漩撤彻微游泊簇
烧	晓浇挠绕侥跷饶灶结社翘
灯	橙澄瞪证蹬炊登礼壹体凳邓葵
燕	咽蕉芜蒸煎萧菊忠庶蘸英秋蕊慕蔗葱痰惹叶葬席患芯菲荆
燎	辽潦撩嘹缭僚疗了尖燃刹隙显煮炎灿熔烟爆煌
烫	荡汤荡熊照炎旦源渣淡愿煮烈原杰旱灰乒宾氮
燃	然痰焕恢尔灰灿淡弥荧炎捞唠谈毯弥肖劳
独	浊烛触蜀狸狞猾猖狰猜钾狗押匣
瓢	飘狐弧孤瓤瓣瓜标膘漂票
瘸	肉架贺希驾腐呐加肴茄咖瘟疗胁病努
卢	肤虑庐芦炉虏驴瘟篇尽蓝盖盏篮盆仑虚滤温遍颅
瞒	瞄满蒙席算睬睁睛啼目蒂锦瞳瞧滞睦棉帽怖布鼎
磨	蘑糜摩么魔靡麻碧术拓司石铜述
砖	传转团专碗诗砾栽褥磷磁碟博硫铁时持恃侍朱咐石府
御	宗奈禁票祭祟示行三碳灭二不崇炭些斋虱否韭襟棕捺径杯
积	债绩责遗溃精损钻价惯睛陨韵晴猜清情圆
颖	顷颗频烦顿须颊头颓硕颇颜顽颁颂类愿项顶顾显
穆	彬谚诊趁珍柏疹棉膨澎稽秒秩香锦穗稻秽称腺煌程秆
窥	规搅见觅砚视现觉观穷窃窟
篙	蒿镐搞稿桥娇侨高矫轿骄膏豪乔亭壕嚎敲停
筑	恐筑巩工竿汞斤析肛江扛芹晰欣近攻折
篡	算省眉看冒箱自楣媚相督眷盲首目太了渺惧咱
筛	狮师佩帅薛埠昙雨两笙启俩筑霍雪笑吊篇
糕	窑糟羔样米羹膳粮精粉粒粪仪粹漾糯牺糖糠粗料
糖	糠搪塘唐米粒粗料籽糊糕糟精粉糙粪
缚	膊搏博傅绒丝缠绷织绢
县	系孙逊系悬丝细洁累索维绣绊组纱纹纯纽纳纪约
翰	蹋塌嗡翁折跃翼习
膳	善糕喜样仪漾牺窑蚁议羹羔美姜膜朦对敬义冈
腻	贰拭试项页式硕烦顿颂顶颤代贵责贡
膨	澎彭彬树趁珍疹穆谚诊厨鼓形周须周彩衫杉彤稠碉须
兴	筒铜桐洞同臼石只且答幅壹租
艘	舶舟舵舷船航舱舰艇瘦舀搜嫂
舱	枪沧抢呛船舟舰舷舵航舶疮苍艘
蕊	芯萄叶苟芍葱惹菊苞燕慕葬慈卜葡葛菜芦莽莫茶苔恭苗思
荡	汤萍烫蒲落菠藻茫范薄荡度渣萌旦踏润滨源
蕉	旧憔礁瞧焦蘸芜奋崔锥进椎淮推堆唯
萧	箫肃啸锈绣英燕革荠苗芯昔艾荆席满渊姊
芜	抚无蕉庶燕蔗蒸茶煎蘸苍旧莽芥舞花借
螃	磅膀榜傍谤虫旁蝙蟀蛀蚊蚪螟蜗蜻蛇虫
螟	虫蜗蛆蜻蚣虫螃蝙蝗蟆蟀蛀蚊蚪蝴
蚂	码玛妈吗冯虫骂闯驾惊蚌骚虫蛹蛾驮蛙蛔蛀蛆蚯蚪蚊
萤	虫莹荧荣劳营蜜莺强虫搔骚闽蚤螟蝴蜻蛔蛙蛀蛆
融	虫蚀闽蚤虫蟹蛋蛮蛙蛔蛀蛆蚯蚌蚊蚪
衡	衔街衍卫冲衙术行征微御霉徊彻徘徙徒很律征往彼
褪	腿退堰银根限恨痕艰跟眼狠很隧随褂衬川良罩
裤	轰库运浑挥撵链莲荤载晕辉车连阵轧军
褥	辱将遵砖传特时持恃待侍附畏缚转膊诗蹲搏博傅咐
亲	衬览榄杂相揽湘霜箱厢缆想目出盹拙楣督茁冒盲屈
谚	诊访谅谤识注谓谆谈诫志讼让该谜谢
讳	语诀讨谋谍诺谓谅谈谆请论谊志认诫误试诗
谋	谍诺讲谎诫谱详谓谊谈请志语试诗议讼护课谦
谍	谋碟志诫询谓诺谈认试诗谱讼课详诀讨
谐	楷阶揩皆诊讹谚谋谍诺谒谓谊谅谈请谎谣志认
诺	谎护诫谋讲谱详谓谍谅谈志议讼谦谨诀
谒	喝遏褐竭渴揭蔼志谱识谋谍诺谓谊谅谈请论
谓	请课谈谊谣志诫译讼调谋诺谍谅论讲认诲
讽	飒枫设飘疯诈谢话诉诱
豫	橡像予预象抒序野舒墅多移侈爹
猫	豹豺瞄锚描垦恳解苗迈袜刀菌屉芬
赖	懒癞初束分解昭沼招叨贫盆忿岔
蹄	啼缔蒂趾踩蹦迹足帝踊践踏蹈
踱	践镀渡踏跋足踩蹂蹈蹦跺蹲蹬躁躏跟
踊	蹂跪踩蹬足勇蹄践踏蹈蹦跨跺唤距
蹂	踩跺揉踊跪足践踏蹈蹬躁趴踱踢蹦蹲躏跟距跌
辐	轰轻富逼福幅轩车辑辖蝠辆轴轧输轮辕轿软轨
辑	轰揖车辐轩轧辖辕转轿辅轴软轨
输	轮偷逾榆愉喻轰车辐辖软轩轨轧愈
辨	办瓣辫辩避辛僻辣滓薛霹宰锌辜辟辞
办	辨辫瓣辩避僻辛滓薛辣霹宰锌辟辜
遵	蹲遭尊褥迈糟槽传特时持恃侍蔚团
选	撰巷起哄共粪戴烘洪拱供冀寒异基恭
迟	犀嘱属这适避逝遍违非匪卜游
辽	燎潦撩嘹僚缭疗了刹显逛文选遭遮遏这逢银源送退
遗	溃贵遣债积贡绩陨损逃价惯韵钻圆
醒	醋腥猩酷酪丑酣酥醇醉酝酵酸酿酗配酌
锭	绽定提堤是针贮嫁家稼滨棕喧铁铐镇
表	表素铲畏青银钳钙钧针钉拓打晴喂清情偎
锯	圣居镊耳古分针耿耻胡枯沽姑咕取估茸苦忿固岔
锰	猛孟栅盆溢滥隘遍温偏好仔李字
错	锚措惜借昔醋暗钳萌莫膜模漠摸草音芭镜暮摹慕寞墓
钱	贱栈浅公镀践残松盏蚣渗掺惨贼讼翁
钢	纲岗冈铜逆溯刚益溢皿册脊锰锅隘盆
锡	赐惕踢易勿吻忽物剔匆
录	绿碌氯剥互铸汇银钳钮钦钉表锤镇钙钧
锥	进椎淮推堆唯崔锉离杂稚雄准
锦	棉绵帮帕瞒满滞腺煌惶啼怖布迫柏泊拍怕伯
阎	焰陷馅门合阁旧关闲间闷闭问闪
隧	遂随障陪防附陡阱队陈陕限陌阻陶除
随	椭隧防陪陌阻障附陈陡陕限阿阱隔除陋堕
险	俭捡脸检除验碱签阴附洽拾恰哈际隔蛤陪陋陕陌阿阻合答
雕	唯谁堆礁锥离进椎淮推虽杂鸡维难稚雄准瞧
霎	雨霉零云霍雪霹灵震霜霞
霍	雨雪霉零震霜霎云霞霹灵
静	挣睁净狰筝争青晴清情擂精靖睛猜授朋硼
颊	题烦频颗硕颂顿顶顷显头颓颖颇领额预顽颁类愿颠须项
颈	劲项频头颗硕顽顿颂烦顶顷颤显颊颓颖颇领题预颁
频	顷颜颁须濒苹颗硕颂顿烦顶显颊头颓颖颇题顽愿项顾颤
头	硕烦顶频颗顿颂顽项顷显颅颊颈颓颖领颇额题预颁类
颓	顽顿频颗烦顷颊头颖颇硕颁颂类愿项须顾顶显
餐	痒食养疮良狼浪娘琅苍灿仓夜枪沧抢呛假
馆	棺馅馁饰馒饵管馏饶饥肴饿饺饼蚀饲饱
馅	饮馁饥馆饰馒饶饥饿饵饼饭
肴	饺饼饵饭饮饥馁饿蚀饲饱饰
骇	驻驮核咳马驶驹驰骗孩该骆驼驳骡验驴驯
骆	烙络略骄胳格洛骏驳路赂驮马
鸵	鸟驼舵蛇鸣能鸭鹃鸠鹊鹏鸦鸽鹅鹤鸥
鸯	鸭鸣鹃鸠鸳鹰鹊鹤鸦鸽鹅鹉鸥
鸭	鸣鹃鸠鹊鸽鹅鹤鸯鸦鹉鸥鹰
鸳	怨鸯鹰鸣鸠鸭鸽鹅鹃鹊鹤鸥
默	点黔吠伏兽献状黑嘿犬墨莽臭哭突
黔	吟默点琴伶铃捻玲冷黑今
龙	拢咙胧庞宠笼垄旁聋袭敌离献膀榜傍
龟	乙弓山齐肃斗门函色臼夷目出巴屯凶丑己已小子夕久又匕
优	扰忧儒偷伦懦擂糯蠕愈傻榆逾喻愉坝侵俊
偿	赏俏勋档当挡膛裆铛倘撑赵尚债损销梢哨峭悄捎消
儡	垒佃叠偎僵个侮每僧偶人俭疆伤腮偷晦梅
储	诸曙者薯堵暑煮着奢屠睹都署
励	肋厉胁勇勤勒助功男劝勋勘动勃劲劫幼万筋荔茄
嚎	壕豪嚷哼唁镐搞停吭高亭稿篙图膏蒿
吓	赫赤赦喇咧嗽倒啊捌吐斗小闹
壕	壤豪坛镐搞停坑坏稿篙蒿高亭
压	厌百豁然坚明堕塑涂奥盟型冒萌宿周墓尔
婴	樱缨鹦赛贝赞员贿贵责贯货圆赏贫负贞页赚购锁赠贱
屿	与举誉臼六匕鼠舀狡化桩稻滚滔焰陷峰身交山旧
岭	领苹吁贰吨倾须濒颂页颗颊频硕烦顽顿预
岳	狱诫言漪试诚咏逛狡诺谓识谈课谁志认详诗询
帮	棉锦绵帕封席希蝗舶柏蒂常线满腺饰迫怖怕拍泊伯布
弥	弥尔燃杯肖不尽劳销敞硝梢悄捎峭哨消俏杯坏尽捞
徽	致缴霉邀彻撇撤嫩澈微傲做厂橄激撒墩维纳嫉
应	鹰志截雄虽焦集崔售锥憔椎进推淮堆唯准
懂	董重种肿动惜冲慌恬葱狸里千童
恳	垦豹猫豺忽忘狠惩愿忿貌解恨怕
懦	儒糯蠕需恒擂坝蕾优扰而惰愉情忧雷电耍
戏	逗疟痘岂豆碰碘磁短丰壹登详研橙灯澄豌
戴	粪冀翼异载惠栽截裁专共选撰寨塞寒基恭团烘拱洪哄供
擎	惊警敬启故奉做矢撒击疾矣蔽撇散捧挨唉枚知
击	系段投疫锻殿壳殷般股谷缎搬毁杀役发淀毅殴设没
挤	济脐扑齐荠拉拄抖摘掉扯剂掠接抗斋
拧	泞柠狞宁按擦挖控技采捐捷拷丰挡撼擂擒扰撮摔携搞搏损
擦	察祭际棕捺按拧综崇宗赊示控拾拴仁奈
拟	凝碍疑批指丸掷拙扎摧揩揍挨爹掀挑抛执抒沃
搁	落阁露拦扳悯润涧略格烙胳洛投们客各
敛	剑敬敢启叙故玫敌数散敞致枚牧攻改收
毙	尸鳖别弊币死庇咧例昆屁能批
曙	薯署暑曼储者堵煮着屠奢诸睹都闸
檀	擅坛杭朴毡樟槽杨杆颤查渣喳梳柱
档	挡当裆铛梢当膛稍党棠尚偿福幅掌堂
检	俭脸捡险签验碱栓榆洽拾恰哈枪答橙给蛤梅钥合合
毡	颤耗尾撬毛檀擅坛毯
泞	拧柠狞宁滨泻沈滓溶汁浮沛沽潮湖
滨	缤鬓宾沈泻溶泞滓演汁汤
济	挤脐齐荠注沾泣滴剂淑卤涉滚漓凉流斋
蒙	檬朦蒙蒙满漠灌滋沮溢沟浓港汉洪洋溯洞且
涛	畴铸祷筹寿浇润法溺浅治弱坎弥
滥	蓝篮舰监溢温盏磕盖遍偏
涩	沥沼征正洁溃漏涉政怔整症歪滥遣灭溜减浅泪疏啃
湿	汤渴瀑漫混涧澜浪宴润溉潦潜踏滚漠渔渣凉淡
营	荧荣劳萤莹莺吕宫铝侣尚捞唠
灿	燃炕迷籽谜粥米餐糕焙烙炫粒粗料咪暇假粱
燥	噪澡躁藻品保呆操棠否绢焙癌区
烛	浊独触蜀绎曙泽择释钾押卖闸曼匣
爵	嚼萝梦环还蔑箩楞逻锣
墙	壮妆将状庄蒋寝蛔回姚茴徊玫禀
狞	泞拧柠宁猾狰猜猖狗获独猿猩猛狈狸狠狂犯
获	获护双只狞猾猿猖狰猛猜犹狸狂猴
环	还逻锣萝箩楞理爵梦斑班蔑
疗	燎辽潦撩嘹僚缭了希肴刹瘸痪痰显
癌	品乔巷吝吞君右噪知咆佑器尝各区包燥澡选撰起
荡	烫盟杯扁汤监盗盛盔益盅孟珊盘盈荡盆血栅
瞳	撞幢钟童瞄赔瞧瞒竞睦睬暗焙接培倍困目
瞪	灯橙澄蹬证登壹礼体瞻眨凳
瞬	睬睁睛崩瞪瞧瞒瞻瞎蒙瞄睦眨盯目
瞧	憔礁惧蕉崔焦摧睦催雏目瞳瞒蒙瞄睛睬睁
了	睹眼盹盼盯燎辽潦撩嘹僚目疗睡眠瞧缭瞄睦睬
矫	侨桥娇轿骄乔镐稿搞篙蒿矮奏知吞短添沃妖矢笑
磷	怜鳞咪硝砂粥砖碗邻礁础碾磕碟碳磁矿砾
礁	憔瞧蕉谁唯确焦雕碳石碾磕碟砾碎硫
穗	惠稼秆私禾秽稻称铁传程移秒秘秤秋科和番香委
窿	萨隆窍窥穷洼瘾窃窒窄突空帘究窖窘椭猜都除郊邦
簇	族房淤芳肪放妨坊仿旁漩于防
篓	屡楼搂缕笛娄申坤呻伸箫笔神
篷	蓬逢返冬般炕杭抗坑吭反簇各疼缝肮搬航板扳
糠	糖慷康米粒粗料籽糟糕精粉糊粪尉迷咪粮粹糯糙团慰
糜	磨摩么魔靡蘑粱麻屎粟气术粥迷咪米怜述
粪	戴冀翼异团米糟糕粒粉共糠糖粮选糊撰精粗烘料籽
糟	槽遭糕曹粮米遵精粉粒粪脓礼浓蹲糯粹糠
糙	粒料粹造糊米糖粗籽糕粉杭告谜糠迷糟粮精浩粪
缩	绽综缤绒绪丝绘给织缭纬线缓绵绢
绩	积债责丝遗溃纤绷缤绢损给缨纷
缕	绅楼搂丝篓屡绣细纠练缅绿维绊统组纹
绷	丝绢蹦缔结绒细组纯纳纪
缝	丝纺纤纹终绑绰绞织络缎缴绊统纱纽级缔绒
总	丝窗编线绵络终纸缠绍纷细囱
纵	踪丝从缎缴纸线绵绑绣维纳纱纠总编络终履
繁	紊丝系累紧紫絮素索系敏哟罗蕴辫织
纤	丝织缔绰绞纺纹缝绢结绒终绊细统纠
翼	翠习翁翰折塌嗡
声	聂闻茸疫毁壳股投耸爷谷殿般殷段
聪	葱耻聂耳职耿取聊联聘耽腮茸
联	聂聪职聘耿耻取耳耽关茸械聊
耸	聂茸声闻趣聋饵椰摄镊伞爷耳耿耻取
臂	壁劈璧譬辟避僻霹辜薛辛宰锌
臀	殿淀股疫杀殷投壳般段盘肾锻谷毅殴毁设役
脓	浓农体礼遭槽胯遵膘甚
胆	瞻担赡小脸誊逼逗脆硼铜桐洞筒同
脸	俭检捡险签验碱洽拾恰哈答给蛤钥合合
临	卧臣宦藏赃器嚣区脏竖肾鉴坚蝉险弹除贤紧严单囊
举	与誉屿摩臼六鼠舀舅旧阎身交稻桩滚摘滔搜
艰	难跟汉叹银退根限恨很眼狠滩摊痕瘫
薪	新晰芹逝崭撕嘶浙析斤渐惭近斯折听匠
薄	簿蒲膊搏博傅藻缚浦荡蒋萍菠茫范
蕾	擂雷电懦儒黄蠕糯葬需芋甘优扰坝
薯	曙署着者储煮暑屠奢堵卖曼万诸睹都
薛	辩办辨避瓣僻辫霹滓辜辛辟宰锌
薇	症屉履征复纵踪徊律很往微从徐徒待彼役行
亏	污夸聘巧朽垮仁跨愕胯粤些三二
蟀	摔虫蛀蚪蚊螃蚣虫螺螟蝉蛤蛇蛉蚯蚌
蟆	虫膜模漠摸虫蝶蚁蚣蚊寞螟蝠蜗蝙蝗蜻蜈蜂蛤
螺	虫骡蛔蚣虫蟀蟋蝉蝠蜈蛉丝累
蟋	虫蛛蝗蝙蜂蛾蝌虫螺蝶蛇蚣呼悉
谜	谅谴谆让注课该访诀讨计谈识
谤	磅膀榜傍螃访谚谅识注诈谓谊谈谆请志认诫
谦	详谨计谱谁课询注诅诈诀许记讨讯订谎
讲	构沟购谋诺谱谎谓志诫议护谦详谣谍谊谅谈请
谎	诺护谋谱诫慌讲谦详谣谍谒谓谊谅谈谆请论
谣	遥调谓摇许请诅计讲谎谍诺谒谋谊谅谈
谢	诗讨话诉诈讽谜讹训课诀计谚诫诱
誊	胜胖谓腾计谣谈请诫志讼课谁详询注诅诈诀
豁	割裕浴俗容害瞎拓谷辖熔榕溶讼蓉铅吩欲却
赚	嫌贝贿贴败财购廉赌账贩赠赔贱贼则谦赡贮赎兼
赛	实寨塞寒宝贫赏圆惯损钻贝遗韵溃陨债
购	构沟讲赚贝赔贱贼赎贿赐赠赡赊赂贬贮贴败财则
趋	盹走起赴赶超趁赵越钝囤趟纯吨趣
蹋	塌跃翰嗡翁踢习折翼翠
蹈	踩滔稻足蹂蹦践踏跺趴蹄踱踊踢躁跟距跌
辖	轰瞎辐转车辕辑输轮轩轧辙轿轻辆辅轴软轨
辕	远猿轰园车辖辐辑轧输转辙轮轿轻挽轴软轩
舆	车连库军轧裤链莲范实轰较载运荤晕轴浑挥软轩阵轨
避	僻霹辩辟办辨瓣辫薛滓辛臂壁辜锌劈譬宰
还	环逻锣怀坏楞梦萝箩爵蔑
迈	藕遇隅偶愚寓万厉遵遭满袜瞒席
邀	放激缴族遍窍傲敷于雇房橄撒澈撇撤嫩做炸
酝	温醋瘟醉酷酣醒醇酵酸酪酿丑酥酗配酌
丑	酥酣酗配酌酷醋酪醒酬酝醇醉酵酸酿
镀	渡踱钱公度镰械戒遮贱松扩旷诫矿贼铺蔗庶翁
锚	错描瞄苗猫钳曲钟茵茴菌曹迈铅袜金厉万
键	健建挺奴蜓涎肄怪又双只庭诞艇津锋笔
锅	过涡窝祸蜗滑铅猾铭乱骨镐铛朋铜
锤	捶唾睡垂邮钳锻铣甜甘千
锹	揪秋秋秒稍禾俐酥潘播审愁萎秦
锻	缎淀搬段发殿般殷股投击疫谷毁壳役系
阔	活舌括恬阀闻闭问门甜刮板闺闸闲间开闰闷闪阎阁
板	问阐操闲间闷闪门枢岖呕阅闺闽闻闸闰开闭合
隐	稳阻际隔院肛瘾险隘陨阳陪陆阴陶陷除陋陌背
隶	逮襟禁示棕宗奈标捺斋御祭票崇祟
虽	雄截唯准雕离杂锥难维稚进椎淮推堆
霜	雨霞霍雪箱露霹厢震霎霉零云
霞	露雨暇假霜霹虾雾霍雪霎霉零云灵
鞠	革菊鞋靶勒鞍秋靴缰鞭千霸
韩	违伟纬苇围拿干韧朝斩干笨
颗	频颖硕颂顿烦顶顷显颊头颓类颇顽颁项须颤
骏	梭峻唆俊竣酸骆驼驳驮马骑骚骡骄验驶驹驻驰
鲜	癣祥洋羊详群搓氧你差
鸿	江鹏莺鹉鸟鸭鸣肛扛鸽鹃鹅鹊鸦鹤鸠虹缸红鸵
鸽	鸣鹃鸥鸭鹊鹤鸠鹅鹉鸦鹰
点	默黔玷沾贴站帖黑店嘿占墨
斋	蒜崇齐棕捺示察襟膘标漂宗奈剂际赊综
丛	茸取最娶业撮共耳支暴趣益聂锯寨闻塞溢鼓寒揖港
向	响晌乡向袄巍鬼魏朗奥几么廊乔参晋高庸唐
垒	叠儡墨里畦园畴埋黑田烟里哩量童思胃重土鲤
婶	沈审嫁婉番播潘妹翻泻稼姑妓秋东禾委
戳	羽耀跃翁翻翔翅扇准翰胶折塌嗡
扩	旷矿广抬掺挨找械拭镀撼遮渡捶甘戒
掷	郑挪梆娜哪榔椰送郊绑爷廊
扰	优擂忧扳懦糯儒蠕投搁坝抗披反蕾处
撵	轰挥扶裤运浑链莲晕荤辉车连轧库军
摆	罢态熊择能押批揩搅比庇曙烛泽浊独触钾
断	继新斯斩祈所析近折听掀斧芹匠斤
朦	檬蒙蒙蒙膜脏脓膳肝且菜冈同
檬	朦蒙蒙蒙横桦模权构柑槽械朴棋植柄桐且菜
柜	贵遗溃框贡枢颗烦页责颓频硕显顿颁颂项顶顷相
柠	泞拧狞宁榕棺棕榆植枯枝杖稼栖末
台	台杜桂肚树桥嬉远结碉周吉
归	扫妇帚浸侵伺叼带虐慧雪啼啃止刁蒂帝肯
泻	写沈滨泞滓溶汁滔婶插沽沛臼
沈	婶泻潘审滨泞滓溶汁番播翻
滤	虑炉庐芦肤唬驴卢虏据疟
溅	贱员侧狈赞贵贯货责溃贼贝赁厕费贺买贷贡
瀑	爆暴漫湿渴汤溢港混洪涧润共
猎	腊蜡脑恼巡巢猿猖灾
璧	壁臂劈譬辟玉避僻辜霹莹薛辛
瞻	胆赡担瞪瞎瞳瞬瞧蒙瞒瞄睬睁睛睦眨
础	楚旋漩碎歌破砍磷礁砖砾磅碾碟碳碗婿硫
礼	体灯瞪蹬橙澄壹证祥脓浓福
秽	秒科稿稻秆程禾穗稼称秤租秘秩秋和私番香委秀
窜	鼠穷窖窄窑窝窟窘窗舀空窍窃窒穿突帘究洼
窍	激缴邀族放窄穷窃敷窿窗窜窖傲
箫	萧肃锈啸笔笛绣爪篓么竹渊姊帘策笋笨第笑笆竿臼抓八
简	涧间门们兰闲闷问冕闪澜拦烂润栏悯猖晚
粮	量糟糕精杆粗米查糯粹杨秆粉粒料籽粪
织	丝统纤职缔帜绒绰绞纺纹线缠绢结细
绕	烧晓浇挠侥结跷饶续丝绷缠绢绝绒维
缭	燎辽潦撩嘹僚疗丝织缩绘缤线缓续综绵绢
绣	丝缕绅细纠绳维绊组纱纹纯纽纳约红纪
坛	潭谭缸缺罐樟遥摇淘掏萄
翘	翔翅翻翩翎扇羽耀塌习翁
翻	翩翔翅翘翎扇羽戳翰折塌嗡翼
职	帜织识聂耳聪硫琉梳流耿耻取联聘疏耽
聂	摄镊耳茸耿耻取爷闻职聪椰耽
脐	济挤齐荠丹肪剂朋腿斋肚腋月胰胖肺肢
旧	蕉阎奋夺崔难锥进椎淮推堆唯截雇臼杂离礁蹈瞧雕稻桩
藏	赃脏宦臣卧临匀冯莽苔鉴肾坚卸冰蘑蔗竖贤紧盐茂扇翔
萨	产窿铲邢防笙邓隆随椭郑邮部啊郎郁那邦
蓝	篮滥盖监舰盏篇盆磕卢瘟尽仑遍溢偏
藐	貌捣笆芭皂薇前脾脉萨皆蒙菜白巴腺肥帕
借	籍藕耕模萌昔耙草芭芙莫措耘耗蔓暮摹慕幕墓葛募
荠	齐脐济挤芒芳剂斋菩荒萧苗芯昔艾莲蓄蒿蒂
荐	茂芝蔗莽苔荠萧菊苗芯昔芍艾
蝉	弹虫阐蝠蜈蝇虫单蟀螺蜗蛤蛇蚣蛔蚪蚌虾
虫	蚤蚀搔强虹虫蛆蚯蚓蚣闽蛋萤蜜蟀蟆螺蝇
复	履栗要贾粟薇症屉踪纵迁腰栗复价御从徐
谨	详谦仅诅计订谱谋诺请课谁诵诬诚话
谬	胶寥耀跃折认诊谚识讥谋谐谓谊谈请
丰	岂痘登逗短竖富艳豆凳壹盒合辐凯
赘	熬贤货员赞赁资贺贵贷责贯狈贾费买贸贡侧
蹦	踩足蹈绷蹄踏践跷踱踊蹂躁跪跺跟距跑
踪	纵从趴跌跺跳足履迹跟距跋
躯	枢岖呕驱身躬躺躲区操板欧穷鸥殴儿品
转	传轰砖团辖车专辑轩轧辙辕轿辐输轮轻辅轴软
辙	澈撤彻轰较车转辖辕轿辑输辐轮辆辅软轨轧
医	酒酱丑醋酣酥酗配酌酷酝醒醇醉酵酸酬酪酿
酱	浆桨奖医酒丑醋酣酥酗酌配酝醒醇醉酵酷酬酪酿
厘	量钟撞短枚会黑里瞳缠幢里理狸埋哩
锁	琐销铛钻贝贫赏员贿烦钞贴败财狈盼贱贼损则贞负页赛赞圆
镇	慎填真颠宜针铺锄直铐植值锭铜且
镐	搞稿篙蒿桥娇侨镶矫高轿骄膏壕嚎停锤
锤	追链镐镶铲糙铝攘壤嚷
闯	驾骂码玛妈冯惊蚂马闻驻驶驹驳驮驰
离	篱敌进杂锥椎淮推堆唯鸡雕献谁稚雄准崔
杂	椎稚进离锥淮推堆唯谁雅雄准崔
双	只集焦售又奴获获健怪崔庭夜键锥护进椎涎淮
雏	皱崔瞧离杂锥稚雄进椎淮推堆唯准惧憔摧催
鸡	奋离维雄准夺杂雕锥稚进椎淮推堆唯截
秋	锹揪革靴鞠鞋靶勒鞍鞭千秋审
鞭	靴便千革更秋梗勒埂缰鞠鞋靶硬鞍
额	硕颗颊频头颇显颁颂顿烦须顷顶题颜类愿颠颓颖顾颤
颜	须频顷颁颗颖硕顿颂显烦顶题额类愿颠颊头颓顾颇领
题	颊频硕显烦顶匙颗愿颠头顾颤领顽顿颁颂须项顷
馏	榴溜瘤饥留馒馅馆饥馁饰饿饵饭
骑	驳驮畸椅崎倚马骆驼骄验驶驹寄
松	胡须发鬓彬射松杉箱衫
魏	巍槐魄愧块傀魂瑰几委丑机鬼萎叽矮魔
鲤	鳄鲸鳍鲫
鲫	唧卿节即鲤鳍鳄鲸鳞
鹃	鸣鸽鹊鸭鹤鸠鹅鸥鸯鹉鸦鹰
鹅	鸣鹃鹊鸭鸠鸽鸦鹤鸥鹰鹉鸯鸳
冬	疼终客洛阁冬逢返处锋路贩略胳烙格峰降叛板
咽	燕哎哗苏叹瞒满哄豆诺磁嘶
坏	怀还坛壤逻坑壕环卖培锣遇坤址罗萝箩
垄	聋袭龙宠庞笼咙拢胧旁榜膀傍丹离螃磅恃
宠	庞笼咙拢胧龙垄聋榜膀傍袭旁螃磅
庞	宠笼拢咙胧龙垄螃聋榜膀傍袭旁磅
庐	芦炉驴卢肤滤虑疟盏颅虏虚唬
惩	征症微恩忽霉往恳悠息怒屉兜德循徒待很徊律彼役
怀	坏还逻环悴慢锣遇忙罗萝箩
懒	癞赖嫩漱嗽喇速初辣束懈快刀忿
攀	樊希矾棒稀捧驳疲奉肴筷爽椅降拔快决
拢	咙胧庞宠笼龙垄榜膀傍聋螃磅袭旁
旷	扩矿广械镀遮渡晒甘戒踱诫暗饼钳柑蔗
橱	树厨栈械梭村台橙钱浅俯松鼓私森喜府寺
沥	雳历历赋止武啃趾涉歧扯址岁肯企涩潘汤
濒	苹频倾吨贰吁颜顷岭须烦颁须页颗显硕顿颂顶
爆	瀑暴焊烘共烂洪拱哄供粪鲁普异基恭
烁	砾药乐炫机吆玄叽似畜讥饥煤后丝以幻拗关么床
牍	续读赎片牌版卖环待壮顺亚串甲画
兽	吠哭器献默伏状莽臭突犬单战鄙弹嗅狱袱奖
琼	现玻斑班璃焕涣换唤琉玖夏
瓣	辫辨辩办避僻辣弧滓辛薛瓤狐孤霹瓢宰
畴	涛铸祷筹寿墅园畦野垒弱埋坎里云
疆	僵缰丑钮扭羞亏仁纽会画量黄票三二
瘪	咱自边仑瘟沦抡伦算轮狈瘩痊省眉首论
蒙	朦檬蒙瞒瞄蒙睬算瞧睛睁盯目瞻瞳瞪瞬瞎睦
碍	拟凝疑砌硼歌砍碳石确硕碌碑硝硬砚朱破
祷	畴涛铸筹社寿福结祖礼祸祥祠祈
获	获护稚双只秽穗稻稼称稀秆程移秒秋和私利禾
稳	隐稻称租稠肛秽穗积稼稿程稀秆秒稍秘秋和私利禾番背香委秃
帘	镰廉兼么嫌歉乏赚箫箕戒鬼谦
簿	薄蒲膊搏博傅缚浦符甫肘等铺补脯捕圃哺沛
簸	箕菠棋其皮疲欺期被破玻波披彼坡
签	俭脸检捡答险验碱合洽拾恰哈合八拿筏敛剑钥给蛤
系	击紊丝紧系繁累索紫絮素缎哟罗蕴辫段
茧	蛮虫萝煎绣绅索蚤罗蕴前药剪虫缕蟆螺绒
绎	释泽择译丝细续缠结绒缕绅
绳	丝绣细纯纪绢蝇维绊组纳纱纹纽约纠结
绘	给维丝纳缩细织缭缤缠续纬线缓绽综
罗	萝箩逻锣维丝累蕴众系罚罪骂紧置紫絮买紊索
缴	激窍致邀线丝绵纵缎纺编缝纹纸放总络终族
羹	羔窑善美糕姜义对膳送墨焦黑掷郑蕉艾牺样
腊	猎蜡脑恼巡巢灾剿奸妥
艺	热魂势盖梦爹云丸执藏寿菱莽茅
藕	迈借愚寓遇偶隅万籍厉萝英芙薯梦蒂席满拣
药	烁砾乐慈关畜玄吆机滋似蓄叶菜茶么床叽磁拗以幻
蚁	仪议虫蛾义蟆蝶蜻蛇蚣虫蝉蟀螺蟋螟螃蝠蜗蝙蝗
蝇	虫蛔虫绳蜕蛙蛀蛆蚯蚊蚪蚌蝉蜈虾
蟹	虫闽蛋蚤融蚀解蛮虫懈萤蜜搔强
裆	铛档挡当当膛党幅尚偿福棠掌堂
襟	棕蒜禁标捺膘际漂崇赊综察
袄	澳懊奥制筋向焕涣换唤衫央痪只血自厌
谱	识讲谎诺谋诫讼谦详议护谍谒谓谈志谨询计
识	谱谅谆诲诫让讼注谤谚谒谓谈志认诗试该询访
证	灯橙澄蹬瞪诡讯谱讳谋谍诺谓谊谅谈请
谭	潭坛谓语诬评计订谱识译谣谋谍诺谒
讥	叽机饥诫讼谱识议谎谋谍诺谒谓谈请谅谊让志
赠	憎增僧贝赐贱贼层赡赎赔贮赚赌贿贴败财则
赞	钻员赁贵贯货责狈费贺买贷贡赘质资贾贸厕贝溅测侧
蹲	遵踩践躏足尊躁踱蹂踏跺
蹬	瞪灯橙澄证蹂踊跪躁踱跺躏足登
跷	侥烧晓浇挠饶绕足蹦践踏踩跪
轿	矫桥娇侨骄轰辑辐稿车乔辙转镐辕辖输轮搞辅较
辞	锌辟宰辜辛瓣辫辩辨办辣乱滓避僻薛骨
边	咱瘪自遍道邀游房遗递膀榜傍逢透于肪方窄旁
镜	境竟钟暗忆樟亿赔障音竞焙接培倍锌意章
铲	产腥猩醒隆牲生性姓星谚萨甥濒锤苹
链	轰莲连运裤浑挥荤晕撵车轧辉库军轴软阵轩轨辈载
关	药门阎合畜闽开闲间闷问闪玄阀吆
难	滩摊瘫艰汉叹锥进椎淮推堆唯离杂虽雕维稚雄准坐旧
雾	务霞霜霹露霍雪茅零雨震霎霉灵云
靡	菲罪排啡匪诽徘魔糜磨摩么非
韵	损陨圆赏遗员绩积溃价惯债钻赛
类	颇烦颗显颂愿频头颓颊颖领硕顽顿颁预须项顶顷
愿	显烦频硕顶顷类颠题顾颗颤颊头颓颖颇顿颁颂顽项须愿
颠	硕颂烦顶真愿题颗颊频头颤显顽顿颁项须顷
馒	漫慢幔馅馆馁饰蔓饶饥馏肴饿饺饼饵蚀
骗	驮马匾骇驶驹驻驰骆骄驼驳驴驯驱
胡	松须鬓发葫蝴湖糊胡居苦枯沽姑固咕估
鲸	晾凉掠景鳍鳞谅鲤鳄
鹉	鹊鹃鸽鸭鸣鸠鹅鹤鸥鸦鸯
鹊	鹃鸭鸣鸠鹅鸽鹤鹉鸥鸦鸯鹰
鹏	莺鸿鹃鸟鹊鹤鸭鸣鸠鸯鹅鸽鸵鹰
丽	洒晒尘鹿比庇批锅蜗过滑涡
劝	欢观罐胁动劫肋另励勤勋勒勘助功幼咖荔茄男
咙	拢胧宠庞笼龙磅啼垄谤榜膀傍聋
嚷	壤攘镶让酿嚎哼唁吭品噪丧图镐谅搞瓤囊
严	嚣器愕葵三哭单咒二天些仁
嚼	爵还褥喘将咐嚎环逻噪嗦锣
壤	嚷攘镶让酿壕坏坛坑丧镐搞培瓤玷囊
孽	荸享字游厚薛菩辛游脖浮俘萎宰季孝李子
宝	实赛钻赏贫圆积遗溃惯损债陨
悬	系县哟纯系约恋愁累索洁细孙愿絮您素紊瓜
攘	壤嚷镶让酿搞掠拥擅摔掖抗扑
拦	澜栏烂兰拣搁柬炼闲涧闭
搀	才馋揩批挽摆逸指比冤昆兔庇屁
胧	拢咙庞宠笼龙膀垄榜傍聋螃磅袭旁
澜	拦烂栏兰涧润柬炼拣闲闭悯渔练们简
弥	弥尔涨没溺消燃涣杯淌澳渔灭涎淑削敞硝涵
炉	驴芦庐卢肤滤颅虑唬疟虏据号焙虚
献	敌吠伏离犬兽默龙状莽臭哭突帝器奖旁
痒	养餐食良狼浪娘疮琅瘩苍痕仓艰馁枪沧抢呛
症	征薇履屉惩复微踪纵霉往循徒徊律很待彼役
矿	旷扩诫广砾碾磕碳碟硫碘碰研石
矾	禁合答言焚椅桐蘑痘楚筒石础铜减喊洞洽拾恰哈
砾	烁药讥碟吆叽乐磁砖机碾硫碌石矿礁磕碳碗
竞	焙培倍赔陪兄菩镜瞳境况钟忆樟撞亿暗接祝泣拉
筹	畴铸涛祷寿等云丢弱坎
篮	蓝滥舰监篇盏盖盆磕遍偏
籍	借耕藕模耙耘耗笙昔牛鹊措箱筷节萌符策笋笔
糯	懦儒蠕需擂坝精粗粮扰糟优糕粉米蕾
团	团粪传专料籽转砖米糠糖粒粗粮糟糕粹精粉糊栽
辫	瓣办辨辩避僻滓辛辣丝薛霹辜宰哟辞锌辟紊索
缤	滨综绽缩绒丝鬓绪续绘缭绩编线缓
继	断丝纠绿绳绣缕练缘绰维绪绞统细绅组
耀	跃胶折谬寥翰塌嗡翼翠习翁
舰	滥篮舟蓝舱舷船舵航艘舶艇监
藻	澡落菠茫范薄荡蒲萍燥噪躁呆度
蔼	谒罚狱辩诫谱识护谎诺谓谍课谁谈志诬认详试
蘑	磨摩魔糜么靡矾合答言麻铜苔筒术蛤给减喊桐洞洽
芦	庐炉驴卢肤滤虑疟颅虏蓝盖菩虚唬
苹	濒频倾吁须岭贰吨颜顷页颁烦须显颗头硕顿颂顶
苏	苏菌莉癣萎你禀禾榛番香委秋和私
蕴	丝罗累系细紫絮紊素索辫哟纳系繁紧绎编
蠕	糯懦儒虫需蝠虹蜗蜻蛤蛆蚜虫
觉	搅觅学视砚规现观见
触	烛独浊蜀角卖摆曙泽择嘴钾押闸曼匣
议	仪蚁谱讲谋诺详识讥护谎谍谓谈请志诫认诗
譬	臂壁璧劈这警誉誓唁信辩避僻辟
警	这唁信譬誉誓擎惊言敬谜谅让谆计谱识谴谦誊
译	泽择释绎谓读课谭谱谋谍诺谊谈诫志诗讼
赢	崩硼员盲受圆贝赡贼损棚则朋
赡	瞻胆担赠赔赂贮贴贝赎购贱赐赋赊贼贬赚账贩则
躁	噪燥澡踩足蹂踏践跺蹲蹬蹦蹈踱跟距跑
释	绎泽择译乎悉幸烛曙呼蟋独浊钾报押薯窃
钟	撞瞳幢童镜赔锌忆樟亿暗焙陪接培倍泣拉垃位
锈	啸肃箫萧绣钾渊针姊金镰锥销银钳钩
阐	弹蝉单板问合闻闸门战关囊阎器阁闺闰开间
飘	枫讽飒瓢疯风票膘标漂佩刮台
饶	晓侥烧浇挠跷绕馅馁饰
饥	机叽讥馁馅饰饿饥饶馒馏馆肴饺饵饼蚀饲饱
腾	胜胖誊驮妈吗马驳驶驹驻码玛驰冯闯
骚	搔虫驳马骡骑骏验骆骤驼驻驶驹驰驮驯蚤
咸	卤碱卤减喊参咸渗掺惨后垢威灭石盐廊
面	麸缅面麦干侈外夕多领弱铭杰移溺舞
党	当棠掌常尚赏裳尝当堂铛裆档挡肖膛
出	龄齿钩拘狗苟驹够此兆逃
龄	伶出铃蛉玲冷零齿
嚣	器硕寡烦显额颗颊频头顿颂颁顽项须顷顶
属	犀嘱迟匪育母尸遮率悲弃屋尿每充菲舟戈职
巍	魏机委叽几萎鬼饥讥魄槐瑰魁块愧矮傀
惧	瞧摧催崔憔雏相篱冒雌渺汇目篡算督眷
摄	聂镊揖闻茸饵趣椰耳聋爷撮耻耿取声耸
携	摧催崔揣扎推惧瞧撬指雏挫拙摊挑
樱	缨婴鹦相楣湘贝赛箱厢赠榄钻滚赚账贿棚柜赞
栏	烂澜拦兰柬闲炼拣涧闭润悯练们简
歼	纤残列韭歹殖殉殊殃死咧例尸
灌	权蒙漠满滋澡沟漾溢港洋洪浓治沿欢劝汉
烂	栏澜拦兰炼柬拣闲涧练闭润悯们简
牺	蚁仪议特牡糕膳牲牛义样漾拜牧物窑看
癞	懒赖速初束漱辣嫩嗽喇痢疲刀
缠	绒丝结细织缚绢维纽约
续	结读赎牍绕丝绎细缠缤绘缭缔绵
兰	烂栏澜拦柬闲炼拣简闭练涧们
蠢	蚕春虫泰奉蚤秦奏蚀搔强闽虫骚蛆蚯蚓蚣虹
蜡	腊猎虫蝉螺蟀蟆蝠蜗蝶蜻蜈脑蛤恼蛇蛉蚣蛔
袜	蔑梦迈川顺萝厉万还锚瞄描薯
览	揽榄缆亲衬屈目出茁胃冒窟掘倔盹相拙
谴	谜让谅谆诽训注诞讹该词诅访订计
护	诺获获谎谱讲谋诫设谁详议谍谓谈志误
誉	这誓与譬警举唁信屿言谜谅让谆计
赃	藏贱贼赎赠赔赋赊贮贬则贝臣赡脏购赐赂赚账赌贿贴贩败财
跃	耀蹋胶折谬寥翰
轰	莲范载车转辖轴轩库军荤晕链撵辑辐裤辅较运
辩	辫瓣辨办避僻薛辣滓辛霹狱辟辜蔼罚宰
镰	帘廉镀兼嫌赚歉公铺钱锈谦钳钓铅松戒
铁	穗砖传针转截团惠栽专锭戴载裁
铛	裆档挡当销当膛党尚偿福幅棠掌堂
霸	坝巩革需鞍鞋靶勒雷电秋鞠靴
霹	避僻雪霞霎雨霜霍辩办辟
露	霞霜落雪灵雨霹雾霍震霎零云搁
响	向暗障乡音意菩镜忆樟亿境陪
顾	频烦顷愿显题颗颊头颓颖颇领硕顽顿颁颂须项顶
驱	枢岖呕躯马驹驮骗驻驶驰骄验骑骤骆驼驳驯
骡	螺马驼驳驮骚骄验骑骤骏骆驴骇驻驶驹驰
魔	糜磨摩么靡蘑几麻术魄魂瑰槐愧块傀
鳍	嗜鲸鲤鳞鳄鲫
莺	鹏荧荣鸿营劳鹃萤莹鸟鸣鸯鹤鹊鸭鸠
鹤	鹃鸣鹰鹊鸽鸭鸠鸥鹅鸦鸯
囊	索嚣阐灵器丧弹嚷壤攘镶蝉愕肺沛
峦	弯恋变蛮湾讥绷絮言砾丝识织纤谜誊谎
弯	峦恋变蛮湾讥絮言砾丝识织纤誊谜
摊	滩瘫难汉叹摧挫艰推催雌汇坐锉惧篱罗蕉雁
权	灌檬横桦模构样槽械柑枢获台棺欢劝朴棋吐善
欢	劝观罐坎玖吹欧歌钦砍炊歉歇款欺饮欲软亩欣次疚
洒	晒丽鹿混尘能沉比批昆庇屁
滩	摊瘫汉难叹汇艰淮催雌满摧坐
瓤	弧狐孤瓢瓣瓜攘壤嚷镶以
叠	垒儡且胃宜谊沮姐锄粗组蛆祖租阻助
瘾	阻隐郑郊萨窿椭际都啊郎郁邢那邦
癣	鲜祥苏你为羊氧差群洋痛羞疚痪搓
笼	庞宠胧拢咙龙篱垄聋膀榜傍袭旁螃磅
聋	垄袭龙笼庞宠聂胧拢咙茸闻摄镊
听	德厅患宪聪环还匣怀坏腮楞钾押串甲
脏	藏赃朦膜臣卧宦临肾脓胶肠脆冯卸脚坚
袭	聋垄袋制装裁裂依龙笼庞宠衣胧拢咙
衬	亲榄揽缆览相霜湘箱厢杂想川盹目出盲
读	志诗赎续译牍谓讼谱识谭讲谋谍诺谊谅谈请
赎	读续牍贝赠购贱贼则赃赡赔赋赐赊赂贮贬赚贿贴败财
铸	畴涛祷筹寿录基赎铁钱铭铃弱坎云
鉴	臣宦卧屡藏申临买肾坚娄赃顺坤呻伸盐贤骂紧置罩众留
缰	僵疆革鞍鞋靶勒鞭鞠千秋靴
颤	项显颗频硕烦顶颅颠愿题毡颈头颊顽顿颁颂须顷
骄	桥娇侨矫轿骆骑驼驳骗驮马骡验驴骏驻驶驹驰驱
脏	体肮葬髓骨朦桦膜哗滑惜苛
须	胡松须鬓发苹颜岭吁濒倾贰吨
鳖	别弊毙币渔鱼鲁蔽厂撇敞燃
鸥	鸣鸽鹃鹤鹊鹅鸭欧鸠殴鹉鸦鹰鸯鸳
苏	苏咽哎哗吵萎菌获噪磁叹哄
恋	变弯峦蛮湾讥悬絮言砾志认哟丝
搅	觉窥觅见砚视现规学
晒	洒丽鹿尘昆棍混能比批
窃	呼窄乎穷悉窖蟋窍窗帘窥洼突空究窜窑窝
缨	樱婴丝绩缓组纲缆绷纤缔绢结绒纷网
纤	歼丝维纳绘给绑绣组约红纠绒韭
才	搀馋丝缠缆织绷线缀绵绢绝给络绒结
蘸	蕉芜焦礁醋憔酒旧燕广蒸蒙煎医西酝丑瞧醉酷
萝	箩逻锣罗蔑梦还环爵维楞
变	恋弯峦蛮湾讥疾矣徽致砾缴敛敌数敷蜘敬给敞敦敢
逻	锣萝箩还罗环楞爵蔑梦
显	愿烦颗频硕顿颂顷顶颤类题颊头顽颁项须
惊	擎吗闯驾骂码妈蚂玛冯警马驮腾驼驻驶驹驳驰驯
验	捡俭脸检险马骤碱骑骆驼驳驹驮签骄骡骚驴骏
髓	肮体脏骨滑腿辞贿郁猾肴
体	礼脏脓瞪灯橙澄肮壹
鳞	磷怜鲸鳍
霉	微彻征衡御徒徊往冲衔街术徘衍循徙很律彼复从徐
嘱	属迟呢犀呕碾叼叨职硫吗啡哪砸育
坝	霸糯懦儒蠕擂扰优革蕾需雷鞍抡沦伦鞋靶
揽	榄缆览衬掘亲拙摆撬损招搅摄握扫倔扼盹拒目出眷看屈
瘫	滩摊难汉叹奋艰催篱罗夺坐摧汇雁座蕉惧锉雌雄
矗	直植值置殖宜谊且诅脖蛆肺沮姐沛
罐	欢劝观缺缸坛遥摇淘陶掏萄唯谣
蚕	蠢虫潜既蚤概溉慨强蚀搔
让	谅谆嚷谜镶攘壤识谴酿该注访
艳	丰色岂邓豌逗痘豆头碰碘凯吧礼瞪灯橙澄磁短
酿	醇醉镶攘壤嚷让醋酷酪酝醒酵酸丑酣酥
雳	沥历云震灵霎霉零雪雨霍露霹霞霜
灵	云雨霎霉零霍雪露霞雳震霹霜
千	鞭秋靴靶迁革鞠鞋勒缰鞍霸腰栗巩贾粟栗要
骤	验驳马骡骚骑骆驼驻驶驹驮驰驱聚
鬓	胡须松发缤滨宾
鹰	鹤鸣鸯鸳鹊鹃鹅鸽鸭鸠鸥鸦
碱	俭脸检捡险卤验签咸卤蛤给洽拾恰哈答钥论诲诊敛
盐	监盅扁盏盟盗盔盛益盈杯孟荡盘宦篮蓝盖卤臣舰滥
厅	听德患宪环骂罩置买众库蔑梦串甲坏还楞匣
榄	揽缆览衬亲楣相枕湘箱厢樱睬掘倔盹柜困框目出屈
湾	弯恋峦蛮变讥砾洁织纤谈诫误减给讼这唁洽
篱	离笼敌惧瘫庞宠蒂摧雌汇催进啼
箩	萝逻锣罗环还蔑梦爵维楞
蛮	变恋弯峦湾虫闽蛋蚤蟹融蚀
观	欢劝现视砚规觅觉罐见
衅	奥向制真广分筒袄镇澳懊慎填芬氛忿岔召具兵西
镶	攘壤嚷酿让镐锤丧搞瓤链囊
钥	洽拾恰哈俭答盒脸检捡铃蛤给合谷合
颅	头显颤颗频硕颂顿烦顶顷顾愿颠类颜题颊颓颖颇领
馋	搀才馅饥饮饥饶馒馏馆馁饰饿饱饭
镊	聂摄茸锯椰聋闻爷辑饵耿耻取趣耳声耸
驴	炉芦庐驻驳马验骄骡骑骆驼骗骇驶驹驰驮
缆	榄揽览丝纪绝绍缠绷编绢纷细纫
躏	蹲蹬踱蹂踏跺足跃躁跷蹦蹈蹄踊践踢踩跪
钻	赞贫损遗积溃惯陨债宝赛圆
锣	逻箩萝罗还环楞爵蔑梦
鳄	鲤鲸鳍鳞鲫
凿	疫毁躬般殷段股投锻谷殿壳役穷发身淀毅殴躲搬设杀
鹦	鹤鹊鹃鸭鸣鸠鸥鹉鹅鸽鸦鸯
郁	遥摇缺谣彪彬脂能杉萄疹觅膨棚淘掏彩衫珍
吁	苹岭贰濒吨倾须硕页显顾颗颊频头烦顿颁颂
